Patrica	Milburn
Keena	Kenyon
Marva
Julieta	Chun
Casie	Dabney
Carmelo	Booth
Louie	Crisp
Thea	Heffner
Marchelle	Farris
Verla	Montoya
Cari	Starnes
Marvella	Lujan
Classie	Burley
Debby
Alishia
Margarite	Louis
Clementina	Maloney
Violeta	Guffey
Pamala	Traylor
Vada	Lewandowski
Ladawn
Arnette	Bolduc
Chastity	Yarbrough
Marge	Oden
Brittani	Marion
Jude	Lindstrom
Jaunita	Keating
Rosalba	Fair
Latesha	Flint
Marya	Funk
Rashad	Olvera
Candy	Ruff
Stevie	Ragan
Serena	Puckett
Betsey
Francoise	Frierson
Neva	Van
Ira
Qiana
Abe
Hortense	Lovett
Georgeann	Jude
Shirely	Hebert
Mariann	Cruse
Penney	Keen
Kathie	Magana
Lahoma	Hauser
Sharilyn	Soliz
Trudy	Warden
Leeann	Gallant
Angla	Batson
Christal	Mccallister
Marth
Natalya	Shepherd
Coleen	Michel
Marti
Rosina
Glynda	Cromwell
Cher	Munson
Lon	Reynoso
Donnell	Frantz
Rana
Tora	Mcintosh
Adriane	Coles
Verlie	Bacon
Zenaida	Mcghee
Shayne
Eloisa	Song
Leigha	Wilke
Thu	Rouse
Aracelis	Schwab
Jannette	Chilton
Chanelle	Bounds
Zulema	Southern
Marisha	Mcclendon
Coleman	Petrie
Ryan	Weiner
Priscila	Browne
An	Strange
Kary	Caudle
Evelia	Doherty
Millard	Self
Deb	Vang
Myrtice
Georgina	Milne
Audria	Roderick
Jadwiga	Searcy
Margit	Farrar
Laurence
Carmen	Anaya
Andrew	Baird
Antone	Ireland
Eliana	Gable
Etsuko	Scarborough
Sheena	Cavanaugh
Christin	Alger
Jazmine	Chu
Jerrod	Jeter
Mariana	Delvalle
Garnett	Wheaton
Fabian	Chamberlain
Lizeth	Hass
Rema	Small
Cheree	Blanco
Robert	Schmitz
Gracie	Fitzpatrick
Tamika	Stallworth
Chi	Albertson
Anika	Lipscomb
Prudence	Fournier
Brock	Gerald
Scottie	Ligon
Sammy	Tharp
Stephenie	Almanza
Tamesha	Carrier
Tyisha	Motley
Columbus	Orlando
Eleni	Tovar
Nona	Luster
Fae	Corona
Marget	Wharton
Aldo	Tobin
Roselyn	Becerra
Danyel	Homan
Larisa	Sanderson
Peg	Koenig
Terese
Melissia	Kilgore
Keira
Eloy
Shirly	Harwell
Janell	Tanaka
Christoper	Knapp
Rosia	Zielinski
Janene	Knutson
Jarred	Bollinger
Nakesha	Sewell
Lamonica	Lea
Larae	Spinks
Janine	Wingate
Marietta	Batts
Monte	Mccloskey
Denis	Calhoun
Ria
Maura	Schiller
Lillia	Blank
Corrie	Beall
Danyell	Sutter
Bambi	Jewell
Lanita	Chacon
Callie	Cranford
Deangelo	Huffman
Ardell
Gwyn	Maurer
Carmelia	Grice
Faviola	Kirby
Lakia	Damron
Wynell	Bales
Charise	Atherton
Verline	Broome
Marcela	Washburn
Dania	Sapp
Maile	Christie
Kera
Jada	Temple
Tammi	Seifert
Mel	Vera
Vena	Yang
Tandra	Yee
Allegra	Hummel
Elna	Derrick
Corrinne	Fallon
Nisha	Whitman
Albertine	Pleasant
Delsie	Weathers
Wilton
Shila	Crenshaw
Adriene	Frye
Sachiko	Burdick
Ulysses
Val	Crutchfield
Latisha	Devlin
Creola	Dortch
Phylicia	Sells
Hosea	Hoang
Cleo	Caudill
Dale	Pierre
Tameka	Ramsay
Trena	Carnes
Kathern	Anthony
Branden
Wai	Rucker
Merrill	Willey
Gerry	Lam
Paris	Howe
Diamond	Marcum
Antoine	Merriman
Chere	Collazo
Elisha	Armstead
Sheilah	Clinton
Melani	Cottrell
Junko
Austin	Mcelroy
Ma	Mcafee
Kortney	Main
Lavone	Irvin
Dorla	Mcclelland
Michell	Amaral
Effie	Layman
Jeannetta	Raynor
Charita	Sessions
Trinh	Craddock
Tiffiny	Karr
Shameka	Brewster
Mauro	Driscoll
Rosario	Majors
Jacque	Baggett
Jerry	Valdes
Grover	Stclair
Leisa	Edmondson
Tai	Kuhn
Nicolette	Dalton
Vertie	Pickett
Johna	Smiley
Lanelle	Gallo
Aide	Mercier
Kareen	Belton
Zona	Dangelo
Dinorah	Eaves
Trinity
Felicita	Kline
Rea	Sibley
Elliott	Stoner
Gene	Tolbert
Misha	Mcconnell
Thaddeus	Aguirre
Dorinda	Calderon
Elva
Niesha
Beaulah	Taggart
Tari	Vanburen
Jeanice	Sumner
Suzie
Zofia
Mireya	Zavala
Exie	Isbell
Luetta	Brubaker
Catrina	Mojica
Marg	Ohara
Machelle	Mcnally
Lia	Laws
Alyse	Whitmore
Belkis	Davison
Elyse	Alicea
Hester	Fontenot
Jarrod	Quezada
Travis	Burger
Magaret	Maples
Oscar	East
Kelsey	Hacker
Alexia	Goldman
Eboni	Wingfield
Domitila	Arrington
Dirk
Shalon	Dover
Lavinia	Spangler
Drew
Carry	Burroughs
Laronda
Jacinta	Woodbury
Christia	Givens
Quinn	Saucier
Glenna	Stinnett
Warner	Burrow
Catrice
Antonio	Mckinley
Pasquale	Hamlin
Stephany	Christy
Larry	Coronado
Chantal	Arevalo
Kira	Juarez
Dolly	Hager
Jacqualine	Haas
Shad	Kirkpatrick
Greta	Tilton
Youlanda	Fischer
Kitty	Worden
Iesha	Hinton
Jae
Pearline	Dubose
Shanell	Click
Jacquie	Duffy
Alida	Lowery
Merlyn	Hurley
Kamala
Raphael	Mcdade
Cheryle
Catherin	Beaty
Gisele	Delaney
Vinita	Meador
Lanora
Birgit	Dion
Shizue	Mintz
Jay
Zenobia	Hightower
Otelia	Dell
Lynelle	Forsyth
Krystin	Acosta
Magnolia	Posey
Hana	Lovejoy
Ardelia	Roberge
Siu	Paulsen
Erich	Hadley
Theo
Tess	Maher
Harmony	Currier
Mickie
Brandie	Thibodeau
Rena	Pickering
Chasidy	Ellsworth
Debora	Boles
Vanda
Kisha	Beals
Mac	Keefe
Kori	Nobles
Issac	Egan
Marni	Burnett
Lida	Hirsch
Magali	Fenner
Natividad
Jettie	Conn
Epifania	Meza
Lynsey	Fredericks
Shayne	Schulze
Belen	Mayhew
Erlinda	Campos
Loida
Harriett	Pence
Raven
Sondra	Ratcliff
Veda	Duff
Christeen	Salcido
Monroe	Mosley
Kiesha	Pitre
Charlsie	Humphrey
Brande	Duarte
Corazon	Fries
Teresia	Bronson
Leana	Anders
Dinah	Crow
Latrina	Marino
Melda	Santana
Rebeca	Burnette
Deidra	Putnam
Nidia	Bernier
Candra	Estrella
Andree	Mast
Ouida
Cornelia	Link
Madelene	Harbin
Toshia	Carmichael
Jolene	Mccorkle
Asa	Thacker
Thomasena
Marlana	Partin
Maritza	Ainsworth
Helga	Emerson
Catharine	Way
Idalia	Lancaster
Gertrud	Cotter
Ha	Jacob
Chang	Reedy
Merrie	Harlow
Joannie	Reno
Madlyn	Sousa
Anh	Markham
Nohemi	Godwin
Shakita	Orellana
Xavier
Rebbeca	Toledo
Selene	Jorgenson
Carissa
Karol	Mcneill
Takisha	Lankford
Sierra	Fort
Darius	Loy
Lisabeth	Beckett
Keely	Stringer
Hermila	Cardona
Carylon	Provost
Lezlie	Crutcher
Calandra	Severson
Lurlene	Maes
Marilynn	Mckeever
Lean	Loera
Charolette	Danner
Geralyn	Whipple
Cierra	Joy
Gerda
Sharolyn	Blevins
Romelia	Shumate
Anthony	Chisolm
Joellen	Barrows
Reina	Rader
Beryl	Martino
Corrina	Kerns
Harold	Mead
Bennett	Yost
Karin	Call
Nida	Whitt
Tonita	Morehead
Alayna	Burge
Nolan	Parson
Carmina	Olds
Lucie	Clanton
Sulema	Domingo
Phebe
Nola	Clarkson
Herma	Morse
Twila
Ardelle	Crooks
Chi	Cavazos
Ardith	Velasco
Liliana	Bonilla
Katheryn	Arthur
Rosanne	Bostick
Mai	Wilhite
Florida	Goode
Alix	Lusk
Martina	Steed
Aurelio	Levin
Isidra	Lacy
Clora	Cockrell
Thanh	Durr
Marlin	Mckay
Charmain	Keeney
Chassidy	Welsh
Melvin	Cowart
Danika	Dallas
Barb	Brand
Sharmaine	Atwood
Gayle	Steinberg
Truman	Katz
Helena	Franco
Laurena	Patten
Ardella	Garris
Kathrin	Lutz
Cody	Hand
Colby	Edmond
Kimberlee	Marrero
Hermelinda	Crouch
Shanika	Lombardi
Flossie	Felder
Kam	Stockton
Venita	Harwood
Zana
Detra	Beaulieu
Maurine	Kemper
Christa
Floretta	Hagen
Iola	Jeffery
Mertie	Saavedra
Samuel	Osborn
Audra	Lilley
Jenelle	Saldana
Cole
Keila	Southerland
Lexie	Contreras
Lavina	Peachey
Glayds	Nunn
Collin	Conrad
Mason
Lyndsey	Pagan
Vina	Lawless
Yer	Matthew
Onita	Westmoreland
Cherrie	Blanchard
Regine
Hae	Durham
Oneida	Tamayo
Porfirio	Stephenson
Deloras	Bullard
Minerva	Simone
Mari	Rains
Ailene	Noel
Sharyn	Bartels
Valery	Haight
Hunter	Compton
Chet	Leger
Rhea	Seibert
Bibi	Chavarria
Raye	Atchison
Sammie	Larry
Adelina	Bolden
Xenia	Cooney
Hannelore	Fortenberry
Dong	Mace
Tomeka	Jaramillo
Jetta	Beaudoin
Janean	Paterson
Mckenzie	Nesmith
Leora	Brownlee
Marcelene	Nation
Chong	Best
Harris	Earle
Ute	Harms
Buena	Kirkland
Valda	Clough
Shara	Frasier
Babara	Beckham
Hyun	Girard
Joel	Mata
Annabel	Herron
Abbey
Arnulfo	Brant
Fumiko
Damion	Griswold
Dawna	Judge
Drusilla	Fink
Maurice	Clapp
Lucio	Jett
Bea	Quinlan
Sudie	Poirier
Rusty	Hobbs
Wilhelmina	Asbury
Rod	Boling
Aleida	Ocasio
Jeanetta
Robbi	Biddle
Dewitt	Yancey
Loni	Elder
Delisa	Murillo
Yaeko	Duran
Luciana	Longo
Nobuko	Keener
Mireille	Bandy
Marna	Canfield
Paulina	Peterman
Elli	Enos
Crysta	Gallagher
Dara
Eddy	Lin
August
Paige	Gaines
Lyman	Maclean
Despina	Henning
Yanira	Sauer
Francine	Cloud
Normand	Norfleet
Hyacinth	Montague
Teena	Covington
Laurinda	Orr
Laurette	Frost
Ivette	Heflin
Daysi	Noonan
Kimbery	Rosas
Trang	Yamamoto
Rina	Meehan
Twanda	Portillo
Tula	Matson
Carlos	Pogue
Delila	Marlow
Jamaal	Quick
Patience	Hoy
Laureen	Morey
Verdell	Taber
Carleen	Boren
Gail	Cochrane
Devora	Rosado
Barabara	Herrington
Zack	Aguilera
Meghann	Byars
Louvenia	Wilbur
Laurene	Bolin
Cory
Phyliss	Desimone
Mikki	Merrill
Nelda	Bobbitt
Marline	Mobley
Elvia	Bernard
Kenyetta	Hull
Jewel	Blaylock
Nerissa
Herta
Marcelle	Richie
Kandace	Chaney
Ying	Fultz
Lenna	Oreilly
Maryalice	Middleton
Andera	Lester
Gayla	Benton
Debroah	Eldridge
Larhonda	Bergeron
Caryn	Castellano
Vanita	Sayre
Yong	Fraser
Tommie	Batista
Chantelle	Burr
Selena	Bird
Melida	Roland
Vickey	Berg
Loura	Bowden
Moira	Shade
Min	Angel
Reginia	Kearns
Chantel
Marilou	Fay
Cyrus	Cheung
Elizabet	Perrin
Roselee	Rosa
Dion	Jacques
Maryland
Elayne	Boss
Nikia	Cisneros
Renato	Rendon
Kraig	Pak
Madelyn	Hargrove
Larita	Bingham
Dann	Hsu
Elroy
Kenyatta	Rudd
Sharee	Vogt
Yang	Prescott
Emeline	Sorrell
Yoshie
Cira	Regalado
Bulah	Daigle
Mike	Loftis
Coletta	Madison
Jewel
Genia	Berman
Kristel	Tice
Filiberto	Abernathy
Susy	Petit
Dorthy	Munn
Shalanda	Pereira
Kayleen	Moffett
Robbyn	Raley
Theodora	Stearns
Jacinto	Mcmillan
Mechelle	Merritt
Euna	Ferrara
Fredricka	Bright
Sanda
Kenisha	Dent
Deshawn
Lelah	Easley
Takako	Vance
Kenna	Mays
Liza	Mccarty
Jeraldine	Penn
Jimmy	Rosales
Carlyn	Lentz
Ashlyn	Rigsby
Elenor	Lerma
Tammara	Villegas
Corina	Greco
Naida	Boyle
Margret	Hankins
Sharie	Custer
Josphine	Bobo
Zandra	Ruby
Laci
Shonda	Brice
Lonnie	Lemieux
Autumn	Quinones
Marlena	Thorn
Quincy	Greenberg
Nicky	Squires
Hilton	Johns
Khadijah	Robinette
Wan	Braxton
Sharri	Woodard
Lucius	Laney
Toney	Hinkle
Karine	Leeper
Tawana	Schott
Kemberly	Calvert
Vonda	Dunne
Lesia
Eddie	Wyman
Vella	Garber
Setsuko	Wakefield
Carl	Geer
Eartha	Kuntz
Emerita
Earle
Sharyl	Weldon
Celinda	Oneill
Suzy	Mcnamara
Paz	Norwood
Natisha	Otto
Jefferson	Yoder
Dylan	Smalley
Patrice	Mejia
Lashanda	Oliva
Cassey	Nieto
Raelene	Meacham
Kendall	Kelsey
Rico	Milliken
Katherin	Olivo
Magan	Graff
Kaley	Kidwell
January	Landry
Shaunte
Trula	Peace
Deanne	Rawlins
Elisabeth	Leroy
Rupert	Moseley
Clarisa	Wynn
Shoshana	Bertram
Solange
Mirian	Kenny
Joan	Nealy
Trent	Whitson
Adrian	Tomlinson
Sage	Frizzell
Donald	Beebe
Gigi	Gipson
Verdie	Calabrese
Dot	Hough
Birdie
Emilia	Buford
Kyra	Talbot
Darleen	Bohn
Sumiko	Fahey
Bobbye	Groves
Elmira	Pinkerton
Alphonso	Chatman
Olene
Tamera
Noble	Begay
Gabriela
Tanesha	Brinkley
Cyril	Reaves
Marisa	Mcfall
Donnie	Baum
Scarlett	Serrano
Mariam	Uribe
Lacey	Heath
Marleen	Etheridge
Melita	Cleveland
Nanette	Champagne
Earlean	Horowitz
Aundrea	Jefferies
Marty	Minnick
Merideth	Kerr
Cheri	Miranda
Hipolito	Pinson
Afton	Shultz
Jacki	Ayers
Samara	Shah
Silva	Slater
Elanor	Ashby
Le	Bernal
Madonna	Story
Errol	Arteaga
Muoi
Madge	Hammonds
Boyce	Moya
Hang	Neville
Brittaney	Overton
Catina	Perdue
Laquanda	Albers
Zelma	Gainey
Kami	Dodd
Lura	Sutherland
Judie	Diehl
Olympia	Casas
Tempie	Gagne
Weldon	Hickman
Modesta	Strand
Sharlene	Stout
Jeramy	Luttrell
Elwood	Leach
Jeniffer	Marcus
Sharika	Montes
Elise
Lyndon	Grogan
Larissa	Burnside
Dawne	Caro
Kris	Bickford
Vernon	Hearn
Lynell	Allred
Maisie	Stack
Dagny	Ochoa
Stefani	Clary
Ling	Register
Valorie
Cristopher	Glaser
Elma	Crump
Elisha	Baxley
Zaida	Martel
Mandie	Pimentel
Ileana	Estes
Magen	Vanhorn
Scott	Hogue
Breana	Sierra
Ariel	Valentine
Wendi	Sommer
Sheridan	Nowak
Shaunda	Atkinson
Xochitl	Shull
Rhoda	Upchurch
Emely	Borrego
Yevette	Lavigne
Roma	Mcclure
Irena	Mahon
Adam	Barrios
Jaquelyn	Blue
Elois	Croteau
Houston	Walling
Cythia	Pantoja
Corinna	Ashley
Andre	Goebel
Elidia	Chavis
Dominique	Elston
Shantel	Comer
Fredric	Spence
Adena	Clifford
Ka	Lorenzo
Maren
Janna	Sawyer
Tameika	Barrow
Akilah	Laporte
Virgie	Bean
Giselle
Judson	Massie
Zoraida	Antoine
Stasia	Knowlton
Shyla	Hess
Rhiannon	Weatherford
Sunshine	Spann
Sabra	Shackelford
Nichelle	Henson
Evangelina	Leak
Lane
Shea	Bruce
Giovanna	Turpin
Katia	Mohr
Margherita	Packer
Shiloh	Houck
Chana	Damon
Fransisca	Underhill
Mario	Mckeown
Sherita	Cornwell
Kylie	Brink
Clement	Wenger
Oralia
Clemencia	Mclain
Kourtney	Morin
Maira
Ona	Platt
Tatyana	Keel
Evon
Kandis
Rosann
Angelique	Rigby
Mi	Hollins
Antonette
Twyla	Coates
Cyrstal	Greathouse
Richard	Tinsley
Melania	Morley
Breanne	Houghton
Suzette	Singh
Rickie	Newell
Genaro	Thao
Sandee	Gates
Gaylene	Delagarza
Floy	Fite
Keli	Croft
Gussie	Monk
Arica	Wooldridge
Yuki	Curran
Simona	Corbin
Henry	Rickman
Vi	Grady
Alvaro	Ernst
Anja	Matlock
Lavonda	Means
Yulanda	Hussey
Katharyn
Juliann	Dial
Cristi	Porterfield
Katherina	Partridge
Kristan	Cotton
Aida	Jose
Tommy	Grimes
Dionna	Gorman
Renea	Hook
Sana	Cade
Genevie	Fugate
Charity	Sheehan
Robbin	Ybarra
Belia	Salerno
Mee	Mayfield
Loree	Toney
Jacquetta	Rubin
Miles	Bunnell
Porsha	Dillard
Kia
Dian	Cecil
Luvenia	Bateman
Michaela	Carney
Bethanie	Franz
Selma	Rosenberg
Janiece
Gisela	Collado
Raeann	Guthrie
Charissa	Gilchrist
Kanisha	Lebron
Alysa	Smithson
Trina	Weddle
Lauryn
Eliz	Gilman
Maria
Elizebeth	Foote
Carman
Margarett	Krauss
Lannie
Margo
Johana	Hostetler
Mahalia	Kinard
Lucinda	Almond
Salome	Colvin
Caprice	Dowling
Allie	Fennell
Carey	Messina
Emerald	Valle
Juliane	Hindman
Mariah	Solis
Rolande
Camie
Wava	Witherspoon
Johnsie	Breaux
Bettyann	Lassiter
German	Maki
Keturah	Sager
Stefany	Hodge
Art	Mccreary
Derick	Steen
Tama	Mcdonnell
Madison	Nickerson
Geri	Donnelly
Tayna
Ellena	Cass
Katelynn	Shook
Juan
Shawn	Eckert
Orval	Nevarez
Teddy
Lilly	Elias
Sydney	Ali
Taunya	Winfield
Micha	Randolph
Judi
Karena	Easter
Dominique	Bouchard
Keesha
Arlena	Scherer
Veta	Raymond
Anneliese
Layne	Verdin
Pennie	Knudson
Shandra	Shores
Thuy	Sykes
Soon	Cummins
Shavonne	Casillas
Ardis	Ricker
Yadira	Whaley
Trey	Edgar
Elina	Mullis
Adolfo	Mcnabb
Seema	Berrios
Marnie	Hinson
Florentina	Kellum
Russ	Staton
Genevive	Heim
Edward	Miner
Billye	Stinson
Ladonna	Ritter
Ammie	Broussard
Dahlia	Downey
Avery
Nicol	Naquin
Kimi	Rhoades
Kiana	Chaffin
Cecille
Oralee	Tong
Libbie	Demarco
Loren	Poindexter
Goldie	Brackett
Maribel	Casper
Micheline	Daugherty
Shona	Barbour
Heath	Vetter
Eli	Spearman
Particia	Loyd
Elinor	Villasenor
Vernell
Dorian	Wampler
Carma	Hinds
Malka	Rosario
Billi	Proffitt
Marla
Winnifred	Crayton
Lang	Scroggins
Bernardine	Kopp
Danille	Spaulding
Ines	Leone
Noelia	Lafleur
Audry	Westfall
Janyce	Holm
Genie	Decker
Rosalva
Gregoria	Jean
Lennie	Myles
Lucina	Laplante
Chu	Briones
Jessenia	Slade
Bianca	Wheat
Tran
Ayana	Lively
Tobias	Quigley
Livia	Huntington
Debbi	Neil
Valarie
Oda	Langlois
Anisa	Read
Suzanna	Muniz
Leilani	Boothe
Doretta	Bartley
Claudio	Sellers
Sherise	Whitley
Lindy	Waller
Keiko
Rachelle	Quiroz
Reda	Rojas
Tiana	Hitchcock
Thurman	Hooker
Kiyoko	Arriaga
Magda	Havens
Leesa	Moser
Jude	Beeler
Susanne	Trevino
William	Coyle
Kasey	Ledbetter
Jutta	Ames
Josette	Goulet
Sherilyn	Halsey
Cathie	Handley
Tonda	Vines
Lisbeth	Nowlin
Jillian	Hopper
Lavonne	Hopson
Arnetta	Stover
Mira	Mosier
Domenica	Helms
Chery	Raney
Cassi	Venable
Frances	Connelly
Brook	Boynton
Kathlyn	Shuler
Azzie
Stacee	Dillon
Carroll	Bertrand
Aurelia	Horne
Walter	Chamberlin
Basil
Chuck	Adamson
Denita	Hickey
Morgan	Hermann
Eugenie	Maness
Emilee	Mackay
Vern	Belt
Marvis	Reagan
Bettie	Stacy
Laurice	Broderick
Melva	Allman
Marhta	Randall
Jae	Rau
Fidelia	Hamer
Albertha	Lim
Drema	Ladd
Ricki	Gulley
Marielle	Iverson
Granville	Cabral
Marilee	Shumaker
Tosha	Plummer
Season	Painter
Kory	Younger
Jolie	Teeter
Evita	Fenton
Quinn	Colson
Dudley	Spivey
Nelly	Carvalho
Kendal	Mcmurray
Cordie	Nadeau
Migdalia	Cote
Valeria	Muncy
Phung	Grove
Tamala	Creech
Ciera	Barnhart
Connie	Pool
Viva	John
Luis	Hooks
Kandice	Joyner
Tiny	Brito
Lawana	Cooley
Janae
Doria	Messer
Dannie	Dugan
Tawnya	Reece
Gilberte	Holcombe
Eryn	Bartlett
Valentina	Grey
Oliva	Breedlove
Marybeth
Annabelle	Stanford
Rossana	Espinosa
Maryam	Lincoln
Ghislaine	Tan
Emerson
Alec	Manson
Omega	Lennon
Twanna	Berube
Carlena	Sample
Shenna	Kendall
Asley	Brenner
Les	Robison
Lesa	Stallings
Linsey	Mathews
Britney	Bassett
Margrett
Tifany	Lanier
Huong	Hite
Syreeta	Ryder
Sharita	Tavares
Lien	Healey
Ike	Kenney
Bok	Herbert
Britteny
Tessie	Coward
Lu	Hardman
Adah	Silverman
Petra	Lemaster
Tonia	Cornell
Emmitt	Dotson
Nia	Jacks
Adria	Villarreal
Hilaria	Polanco
Stephine	Brogan
Corinne	Harness
Joelle	Beers
Daren	Gleason
Tamica	Mesa
Valene	Skaggs
Iraida
Barbera	Bynum
Illa	Landis
Manuela	Chism
Janessa	Holley
Pasty	Keane
Gillian	Levine
Margareta	Stackhouse
Hildred	Emmons
Janella	Harrell
Eldora	Hickson
Lorri	Hailey
Laila	Montez
Oswaldo	Willard
Corene	Abell
Fritz	Do
Lonna	Dias
Iluminada	Dickerson
Khalilah	Betz
Isaura	Ivory
Leonardo	Rocha
Eustolia	Hudgins
Lakeisha	Sturgeon
Carley	Wooten
Elfrieda	Burgos
Lurline	Mcallister
Kym
Karisa	Towns
Georgann	Macon
Janina	Gruber
Teressa
Cecil	Holman
Vilma	Gaither
Ulrike	Leighton
Charla	Bower
Genoveva	Blanchette
Piper	Travis
Letitia
Soo	Cornish
Vernetta	Roark
Farrah	Farrell
Ahmed	Linares
Helene	Barkley
Mathilde	Winston
Flor	Sams
Kenda	Sisco
Suzi	Walden
Karolyn	Mixon
Enedina	Peacock
Milo	Keegan
Venice	Olivares
Nickie
Inell	Camp
Horacio	Abel
Nathanial	Dewey
Jacqui	Starling
Beau	Shipley
Earlie	Gaddy
Jovita	Autry
Shelby	Swan
Jaclyn
Chantell	Madrigal
Donetta	Gay
Porsche	Dancy
Dede	Light
Rosalinda	Runyan
Jesse	Card
Harlan
Julee	Lugo
Odilia	Eastman
Katerine	Covert
Freida	Barney
Ami	Whitaker
Trudi	Garland
Sina	Yoo
Robbie	Harder
Nickole	Coombs
Lavern	Huggins
Esmeralda	Mcbee
Jeana	Loomis
Raylene	Redd
Quintin	Browder
Jaimee	Lindquist
Leonora	Creamer
Brianne	Strain
Michael	Renner
Nannie	Pollack
Leann	Dykes
Candie
Delena	Blais
Magdalena	Snipes
Tiffaney
Berenice
Ceola	Musgrove
Lily	Sipes
Matilda	Quarles
Luigi	Soares
Latarsha
Galina	Michaels
Erminia	Mares
Vergie	Box
James	Vanwinkle
Ernestina	Brill
Natalia
Concepcion	Hutchins
Sallie	Alcorn
Katelin
Noemi	Winfrey
Wes	Littlefield
Adrianne	Fountain
Angelia	Locklear
Kathline	Rawlings
Beula	Wild
Ronda	Daly
Rosio	Clem
Aline	Giles
Svetlana	Farnsworth
Cordia	Mccabe
Marcy	Mullen
Virgil	Lehman
Carson	Barrera
Jenell
Dotty	Shank
Arie	Shaver
Reta	Butcher
Lacie	Wertz
Ava	Eubanks
Felica	Betancourt
Guillermina	Smothers
Claude	Sprouse
Roy	Sorensen
Pura	Schafer
Johnette	Prewitt
Venetta	Barden
Lizzette	Bloom
Gonzalo	Goad
Bryce	See
Rosetta	Wooden
Nestor	Lockhart
Ronna	Blackwood
Janay	Crowell
Vannessa	Acuna
Dollie	Welker
Sook
Linnie	Rowley
Myrtis	Prieto
Rory	Cassidy
Shaneka	Hyland
Imelda	Rutherford
Tenesha
Saturnina	Christenson
Shizuko	English
Florance	Gorham
Reid	Rife
Flavia	Ricks
Wonda	Aviles
Angelita
Nevada	Spalding
Chadwick	Murry
Cindi	Scarbrough
Genna	Archer
Madelaine	Gavin
Socorro	Sledge
Quinton	Dickinson
Otha
Corey	Gannon
Dalton	Rock
Remedios	Funderburk
Karoline	Hatfield
Phylis	Skidmore
Leonore
Napoleon	Hoffmann
Tamekia	Nielson
Shawnna	Queen
Micki
Bette	Gantt
Karima	Callaway
Catheryn	Fitzsimmons
Concha	Ladner
Leeanne	Tatum
Anastacia	Stepp
Curtis	Concepcion
Floria
Olinda	Goodson
Grayce
Dorethea	Neill
Maegan	Ervin
Jestine	Ivey
Julianne	Baumann
Obdulia
Angelika	Hanes
Adina	Bustos
Madalyn	Darnell
Hermina	Moulton
Herminia	Clemmons
Yuko	Sheffield
Dayna
Mohamed	Latham
Sherlene	Cantu
Cherish	Gerber
Tawanna	Rayford
Gary	Trapp
Janel	Coker
Simone
Virgilio	Cardenas
Rachell
Deena	Roney
Yessenia	Dick
Elvina	Dickens
Lorriane
Dannie	Eagle
Gala	Tackett
Leo	Lawton
Reyna	Teal
Clarine	Lyon
Cherise	Donnell
Graciela	Slattery
Sanora	Lynn
Agatha	Wilmoth
Daine	Crews
Luann	Sowers
Moriah	Rush
Dominque	Burden
Else	Stafford
Doloris	Hutton
Rubye	Ledoux
Pok	Conover
Tashina	Hein
Isaias	Flynn
Juli	Truitt
Odessa	Brandenburg
Meta
Shayna	Combs
Ardath	Loftin
Glenn	Cintron
Roseline
Roxane	Mccormack
Cherlyn	Monahan
Quentin	Giroux
Ayesha	Theriault
Francesco	Holcomb
Rudy
Aura	Pippin
Graham	Frederick
Lucien	Mccall
Carlotta	Gant
Colton	Oneal
Jacqulyn	Snow
Madie
Shaina	Mcadams
Asia	Medlin
Donella	Le
Ching	Albright
Milan
Ocie
Dacia	Mcgregor
Latrisha	Rich
Michaele	Steward
Bruno	Trout
Yuri	Fairchild
Lazaro	Ralph
Tomika	Koch
Antonina	Billiot
Davida	Greenwood
Skye	Yazzie
Ferdinand	Dasilva
Adriana
Donovan	Coons
Tiera	Barksdale
Merry	Childress
Joleen
Katharina
Jenifer
Erin	Bautista
Caridad	Wilder
Lasandra	Browning
Josue	Janssen
Ollie	Cameron
Eugenia	Tam
Velda	Plante
Cliff	Ahern
Novella	Ashworth
Tegan
Alejandrina	Thigpen
Hiedi	Mcneely
Eve	Kingsley
Bryanna	Ingle
Natacha	Lafferty
Celestina	Coley
Mary	Bernstein
Kimbra	Hornsby
Digna
Shera
Luisa	Avila
Ione	Loveless
Leta	Frey
Mafalda
Lawanna	Charles
Joi	Ocampo
Hollis	Blanton
Antwan
Daniel	Coffey
Stephania	Monroe
Mackenzie	Kitchens
Li	Renfro
Sharonda	Tomlin
Chance	Cupp
Ngoc	Han
Pearle	Geiger
Alease	Billups
Jackson	Lavoie
Jame	Glass
Dorotha	Branch
Apryl	Walls
Emmaline	Hatley
Kai	Ferrari
Valentine	Hutchison
Ina	Gaddis
Milda
Farah	Medrano
Shaun	Oh
Sharla
Allyn	Wray
Frank	Pickard
Hertha	Whalen
Celine	Riddle
Earlene	Dupre
Alphonse	Pinckney
Shan	Bedford
Londa	Woodall
Cathern	Hartman
Kurtis	Singletary
Lan	Grubbs
Dedra	Guajardo
Camellia	Shay
Kallie	Mello
Taylor	Ely
Caron	Allard
Lorilee	Negron
Logan	Curley
Margert	Heck
Carly	Ogle
Arden	Cushman
Vanetta	Holly
Ermelinda	Dejesus
Lisandra	Hargis
Nena	Culver
Margarito	Finnegan
Neoma	Cormier
Chang	Healy
Jesus	Freedman
Thad	Cason
Aisha	Denson
Marylou	Feeney
Merissa	Whyte
Ingeborg	Ketchum
Vania	Borders
Roselia	Salley
Pinkie	Peltier
Daphne	Lozano
Tyree
Wilda	Bethea
Azalee	Mccauley
Julian	Zaragoza
Cassie
Devon	Pounds
Bell	Thorne
Leonie	Bui
Antonetta	Badger
Altagracia	Lindley
Anya	Pritchett
Kristyn	Romano
Larraine	Lindsay
Fatima
Corliss
Alta	Keck
Raymon	Dobbins
Madalene	Harter
Isabella	Loving
Luana	Shively
Lou
Gabriella	Orta
Matthew	Churchill
Carolyne	Armenta
Taryn	Douglass
Cayla	Zimmer
Casandra
Colette	Hays
Kit	Maxey
Kirby	Trudeau
Taneka	Tuttle
Tillie	Marks
Alyson	Alonzo
Lacy	Andrus
Nancie	Merrick
Gilda	Hennessey
Melonie	Farley
Liane	Briscoe
Cecila	Runyon
Bess	Schwarz
Sarina	Goldsmith
Martin	Mark
Tuyet	Hayden
Jama	Mcgehee
Petronila	Key
Britany	Perron
Mathilda	Reddy
Chaya
Cherri	Hanna
Alpha	Bair
Tisa	Hilton
Michelina
Sherryl	Dockery
Refugio	Christman
Maudie
Esta	Dunlap
Kina	Winstead
Berniece
Hisako	Hills
Nannette
Trudie	Bruner
Mirella	Roden
Ruthann	Jacobson
Sharda	Leavitt
Shery	Thorpe
Delfina
Rozella	Vue
Edison	Grisham
Rosenda	Weed
Benito	Valerio
Shakia	Newsom
Julieann	Conroy
Sarai	Horan
Melodee	Daley
Denyse	Worth
Queenie	Schindler
Latoyia	Abney
Celesta	Stratton
Theo	Gracia
Letha	Isaac
Nicholle	Duke
Marshall
Marquitta	Stamm
Mohammed	Bagwell
Cortez	Scoggins
Terisa	Meeks
Marianna	Fortier
Franklyn	Outlaw
Jayme	Maddox
Yelena
Miguelina	Presley
Susana	Cloutier
Ashlea	Dunaway
Emelda
Rubin	Teague
Karyn	Zamora
Florencio	Aguiar
Ena	Pike
Jonell	Sauls
Bronwyn	Roche
Kaci	Coy
Chung	Galvan
Lilla	Bannister
Glynis	Orozco
Christinia	Tyner
Jose	Farrow
Johnny	Fierro
Isis
Ludivina	Stuckey
Rodrick
Justina	Beyer
Roxanna	Redmond
Bailey
India	Jobe
Vasiliki	Jay
Pamelia	Schaeffer
Gregorio	Hawk
Amie	Branham
Amina	Carver
Theron	Kozlowski
Teodora	Velasquez
Clotilde	Smalls
Aleta	Schell
Rozanne	Reddick
Moises	Needham
Hollie	Libby
Fanny
Terrilyn	Barth
Sha	Hobson
Lettie	Hilliard
Deane	Lister
Shanna	Gonsalves
Marvel	Gage
Delana	Wren
Theressa	Mccue
Jacklyn	Holiday
Blythe	New
Pansy	Fagan
Fallon	Hendrix
Verda	Bain
Richie	Kirchner
Coral	Gresham
Dorene
Michel	Hoppe
Gwenda
Lakenya
Franchesca	Maestas
Kathlene	Mahaffey
Armanda	Bolen
Ramonita	Artis
Lynna	Hackett
Cleopatra	Thrash
Bertie	Wentz
Danica	Quinonez
Evonne	Naylor
Lady	Dexter
Dulce	Peralta
Joselyn	Lachance
Danelle	Oglesby
Sal	Haywood
Jacquelynn	Fortner
Silvana	Tidwell
Janeth	Lorenz
Thersa	Timm
Annamarie	Crowder
Carita	Mattox
Adalberto	Jacobsen
Shaquana	Shrader
Felicidad
Deandrea	Vinson
Tobie	Keeler
Georgiann	Mott
Bernetta	Burnham
Mellie	Cromer
Shanon	Amos
Lindsy	Styles
Marquetta	Workman
Leia	Thornburg
Rutha	Gooch
Kesha	Reeder
Evalyn	Moeller
Jani	Mosby
Karrie
Norene	Mcclung
Augustine	Mims
Alaine	Stamper
Waltraud	Hurtado
Latrice	Bull
Marcie	Mcclintock
Mariko	Pryor
Candi	Hairston
Krystyna	Gunter
Malia	Fraley
Lilli	Armijo
Gerri
Bao	Keaton
Mirna	Pacheco
Cleveland	Mattingly
Stacy	Pridgen
Latonia	Andres
Stephnie
Hwa	Winkler
Lenny	Pride
Ellan
Yoshiko	Schaffer
Vinnie
Bo	Adair
Reagan	Wing
Laticia	Fuchs
Raymundo	Kaminski
Donita	Hooper
Mercy	Donald
Tonja	Kohler
Marita	Hewitt
Ivey	Mayes
Emory	Horner
Hoyt	Millard
Daria	Weis
Florine	Hoyle
Aimee	Navarro
Ezekiel	Weston
Jacques	Willson
Katheleen	Carlin
Elnora	Irvine
Merilyn	Barnhill
Hortencia	Acker
Felipa
Izetta	Kuykendall
Ludie	Swenson
Krysten	Dominguez
Louella	Lo
Veronika	Lanham
Lawerence	Manley
Richelle	Jamison
Tajuana	Duckett
Neida	Mears
Una
Vonnie	Donovan
Lorna	Hannon
Conception	Soriano
Lorette	Fincher
Nadene
Bobbie	Sanborn
Emelina	Lilly
Janett	Hammer
Deedra	Simons
Leeanna	Dickey
Kayleigh	Mcclain
Corrine	Woodley
Carolina	Mccord
Thao	Cosgrove
Ginny	Hatch
Rocio	Oliveira
Reiko
Sherril	Berlin
Delmy	Carl
Robbie	Guerra
Karleen
Cleora	Archuleta
Sanjuana	Catalano
Joaquin	Ferreira
Glinda	Shannon
Eneida	Burt
Mitsuko	Pettigrew
Reed	Noriega
Kyung
Wilber
Evelynn	Amato
Booker	Newcomb
Jason	Ornelas
Tarra	Scully
Jamey	Ash
Nikita	Linn
Charlena	Kern
Ashlie
Eldon	Ordonez
Margot	Gilmore
Hillary	Bender
Jinny	Jewett
Kendall	Gatewood
Korey	Purdy
Ariana	Rash
Deidre	Chen
Julietta
Glendora	David
Kasandra	Calvin
Elfriede	Montero
Adrianna	Martens
Josefa	Grover
Angelyn	Hutson
Suk	Rousseau
Leatha	Romeo
Danita	Sage
Karina
Jeanett	Early
Elene	Billingsley
Sandy	Donohue
Claribel	Fife
Frederica	Nabors
Jackeline	Montano
Loyce	Strother
Shavon	Sotelo
Lorine	Gee
Karey	Rivers
Domonique	Howerton
Milagros
Duncan	Torrez
Sean	Skelton
Delma	Livingston
Meg	Peel
Mariela	Carrillo
Rey	Devries
Gregory	Keyes
Micheal	Aldridge
Garland	Boudreaux
Isela	Wiles
Caterina	Shin
Zula	Cable
Shay
Maddie	Hyman
Viki	Hamm
Shayla	Tarver
Jamee
Pearlene	Leblanc
Annabell	Tirado
Jennine	Mercer
Bernie
Lourdes	Hamel
Romona	Vela
Jarod	Ogden
Armida	Minton
Osvaldo	Avalos
Marianela
Nicola	Stacey
Ilda	Bunn
Argentina	Cuellar
Becki	Lai
Demetria	Oakley
Damian
Maurita	Nicholson
Devona	Whittle
Darci
Cecile	Gentry
Jed	Rollins
Amiee	Bruton
Alina	Corbitt
Florencia	Barger
Serina	Balderas
Annamaria	Buss
Renaldo	Olmstead
Jc	Storey
Sherill	Pannell
Lynnette	Staten
Kasha	Akin
Krystle	Woody
Denna	Coulter
Rona	Bergman
Eleonora	Fritz
Britt	Wolford
Jimmie	Mccurdy
Rubie	Valadez
Shaquita
Bula	Guess
Alesha	Valentin
Otha	Snell
Shasta
Emilie	Wilde
Tanja	Ezell
Josiah	Pomeroy
Merri	Robb
Janeen
Eveline	Hahn
Fidel	Nielsen
Earleen	Ventura
Sidney
Keeley
Starla	Hathaway
Milissa
Janee	Justice
Theresia	Wisniewski
Mitchell	Oshea
Lilia	Isom
Candelaria	Salter
Alisha	Slagle
Windy	Rinehart
Ariel	Nesbitt
Trinidad	Krause
Seymour	Hollis
Myles	German
Numbers
Ozie	Hawks
Lindsey	Bray
Jonah
Edmundo	Gough
Cristobal	Humes
Dierdre	Mowery
Roscoe	Cowley
Jolyn	Houser
Tuan	Samuels
Kandra	Bunker
Oretha	Davies
Toccara	Alcala
Athena	Paquette
Chin	Faust
Sherwood
Lita	Seward
Rosena	Courtney
Mina	Keefer
Arthur	Meredith
Lyndsay
Felisa	Steadman
Lovella	Cornett
Mabelle	Flanagan
Paris
Letty	Marlowe
Alysia	Holguin
Brynn	Coats
Audrea	Branson
Dung
Felisha	Schweitzer
Albertina	Reinhart
Randy	Stubbs
Paola	Ashton
Ivonne	Condon
Olevia	Wesley
Shirlene	Turley
Hong	Pulliam
Zulma	Rhea
Angila	Jasper
Kala	Melvin
Idella	Windham
Dodie	Medlock
Laree	Paxton
Scot	Place
Thora	Boswell
Sherice	Pappas
Man	Cantwell
Glennie	Fain
Karan	Savage
Miyoko	Cardoza
Benita
Arline	Nickel
Ivory	Simpkins
Temple	Linder
Kaitlin	Cline
Kristeen	Terrell
Heike	Buckley
Margurite
Shelba	Dowd
Jamila	Reinhardt
Suellen	Freed
Jeri	Beatty
Jordan	Vogel
Sommer	Barlow
Masako	Kirkwood
Deann	Spooner
Huey	York
Pia	Sparkman
Tyra	Field
Loris	Reardon
Iva	Dew
Era	Sinclair
Erna	Singer
Chun	Caballero
Evelina	Tenney
Breanna	Tellez
Karry	Durden
Sau	Mayo
Jenae	Petty
Mao	Crandall
Iona	Musser
Berna	Pemberton
Jewell	Wetzel
Cherryl	Herr
Mammie	Yu
Mariella	Guevara
Lavona
Alena	Gale
Rachele	Abreu
Lavenia	Feliciano
Charleen	Galloway
Felton	Hutcherson
Jazmin	Woodward
Oleta	Eason
Nicky	Overby
Chauncey	Castle
Kanesha	Fry
Rene	Post
Kris	Hadden
Refugio	Burdette
Angelo	Trujillo
Janetta	Tabor
Myong	Hendrickson
Zada	Logsdon
Moon	Luke
Camelia	Dix
Elane	Bustamante
Halley
Donnette	Bethel
Ima	Mahan
Heriberto	Hundley
Kalyn	Wirth
Jeanene	Venegas
Chloe	Jaynes
Lanette	Larose
Yu	Seeley
Eleanore	Odell
Vida
Xiao	Tuggle
Ethyl	Craven
Ferne	Gurley
Cornell	Hartmann
Laveta	Hyde
Tyesha	Velez
Dena	Moyer
Alise	Colby
Tod	Pease
Ashton	Wylie
Jamika	Vaught
Ji	Matheson
Cris	Inman
Tristan	Ouellette
Wen	Redding
Bud	Purcell
Evelin	Edward
Felicitas	Holden
Irwin	Henke
Earline	Jeffries
Maia	Butts
Sandie	Gilson
Ezra	Pinto
Filomena	Pauley
Zella	Manuel
Philomena	Barfield
Pilar	Tom
Rufina	Goff
Keshia	Faber
Aja	Epperson
Renda	Coon
Lisette	Macklin
Cristy	Beverly
Ofelia
Jayson	Tipton
Russell	Sterling
Cammy	Michaud
Tammera	Devore
Tonisha	Morrell
Elliot	Hildreth
Tianna	Cronin
Azucena	Villa
Monet	Crist
Bong
Anissa	Carlton
Gidget	Ziegler
Tanisha	Barba
Hedy	Monson
Tierra
Beverlee	Hutchinson
Rafaela	Jung
Young	Higdon
Morton	Stidham
Delinda	Canady
Lashell	Pitt
Paulene	Mireles
Jessika	Martindale
Thi	Hubert
Loria	Canty
Lynetta	Sylvester
My	Marvin
Jacelyn	Herndon
Dorsey	Cohn
Dorie	Bible
Tena	Rees
Maryanna	Laughlin
Kimber	Demers
Shon	Bowlin
Lyn	Bueno
Moshe	Sharkey
Celsa	Byrne
Lorina	Kroll
Katelyn
Maragret	Canada
Cara
Lavern	Leslie
Alethia	Burkhart
Velia	Crowe
Babette	Grace
Karlene	Naranjo
Wanita	Mcnutt
Kiley	Hassell
Nova	Thames
Sebastian	Mcewen
Arlean	Rinaldi
Shauna	Neeley
Ignacia	Mattison
Lashaunda
Collette	Coburn
Jonna
Cary
Yajaira	Trejo
Ivy	Duckworth
Arlie
Elicia	Dietz
Elinore
Analisa	Darling
Lucienne	Adam
Lesley	Obryan
Scarlet	Thatcher
Mickey	Kellogg
Maxwell	Waggoner
Carletta	Homer
Jeanie	Gamble
Marylyn	Hatchett
Karole	Guidry
Georgene	Delarosa
Laurel	Hancock
Blair	Lyle
Son	Isaacson
Mimi	Hollingsworth
Aliza	Rosenthal
Leatrice	Wills
Samatha	Ferraro
Lorrine	Tibbetts
Temeka	Granger
David	Prater
Claud	Carbone
Belva	Bowser
Elvera	Jacoby
Donte	Forrest
Hans	Weeks
Odell	Cooks
Rodrigo	Cheney
Venessa	Ashe
Rosaura	Serna
Whitley	Fisk
Raymond	Fuentes
Sheba	Nagy
Esperanza	Coffin
Mara	Stjohn
Arianne	Haley
Dorcas	Quintero
Ilana	Hoff
Corie	Wilkes
Doretha	Galvez
Rebecka	Leahy
Erinn	Francois
Adan
Jamal	Headrick
Echo	Swisher
Albert	Sasser
Dusty	Bravo
Alejandra
Gudrun	Roman
Elmo	Deaton
Markita
Sherell	Paz
Karri	Saxton
Micaela	Hedges
Vicente	Toler
Rosamaria	Rivas
Dori	Gann
Efren
Leighann
Merrill	Higginbotham
Neta	Brinkman
Eliseo	Gould
Mercedez	Pettit
Cinda	Maupin
Kevin	Catron
Mallie	Hedrick
Rachal	Ritchie
Jerrica	Vallejo
Nell	Prentice
Crista	Blocker
Joni	Youngblood
Cordelia	Cuevas
Vanesa
Carlo	Dorsey
Norberto	Babin
Jenise	Paulson
Jess	Spear
Golden	Hay
Benedict	Holton
Patricia	Chestnut
Fonda
Mohammad
Bonny	Maguire
Tynisha	August
Lasonya	Leon
Elvie	Ricci
Charline	Mcarthur
Jocelyn	Reis
Chrissy	Antonio
Shaunna	Slack
Pei	Sheldon
Cleotilde
Jackelyn	Mchugh
Nicolasa	Wolff
Ethelene	Pettis
Elenora	Driver
Alva	Culpepper
Kimberli
Francisca	Carrasco
Tammie	Benavides
Bobbi	Robson
Janette	Connolly
Alesia	Gaskin
Reva
Kecia	Lang
Delois	Luther
Claudette
Kristle	Hamby
Annice	Suggs
Vikki	Dougherty
Delaine	Pack
Chae	Muller
Marjory	Bland
Georgie	Speer
Nathalie	Siler
Shin	Arredondo
Ranee	Ayres
Christi	Vigil
Kattie	Moreau
Vivien	Espinoza
Hershel	Clement
Tressie	Hagan
Allena	Justus
Tamela	Boyles
Sueann	Butterfield
Thomas	Kaiser
Racheal	Pfeiffer
Von	Stegall
Efrain
Cristal	Langdon
Keri	Willingham
Concetta	Huntley
Jeane	Mcginnis
Zena	Conway
Lenore	Billings
Giuseppe	Fonseca
Reatha	Lockett
Devon	Brunson
Natosha	Gabriel
Collene	Tremblay
Barney	Neuman
Carline	Edmonds
Noriko
Charley	Gillen
Carmelina	Curtin
Willa	Silvia
Thanh	Talbott
Dalia	Weems
Mose	Menard
Leida	Duval
Peter	Benefield
Annmarie	Perreault
Karma	Wiggins
Savanna	Madsen
Ashly	Otero
Susann	Wilhelm
Latoria	Stern
Garth	Bowie
Isiah	Sweat
Terrie
Lashunda	Truong
Tony	Kasper
Rosana	Masterson
Chasity	Bradford
Francisco	Penny
Ivory	Alaniz
Clelia
Barton	Cyr
Joey	Travers
Scottie	Kyle
Indira	Herrick
Bridgette	Knox
Josie	Beckwith
Irish	Nolen
Sung	Wiese
Tessa	Ransom
Dayle	Parra
Towanda	Villalobos
Noma	Sosa
Freddie	Looney
Cristin	Zuniga
Patria	Toliver
Shalonda	Asher
Lili	Falls
Eugenio	Cousins
Kali	Donahue
Dannette	Bowling
Salena	Finch
Nancey	Staples
Alonso	Conti
Carlota
Venus	Phipps
Vito
Maryjo	Veal
Asha	Nugent
Hanna	Gillette
Modesto	Smyth
Shala	Godfrey
Tracee	Folsom
Mitch	Newsome
Tien	Glenn
Fernande	Escamilla
Eladia	Sawyers
Sol	Birch
Liana	Vanover
Jenette	Melancon
Maisha	Ridley
Tana	Applegate
Gino	Dwyer
Adele	Piper
Lesli	Swain
Angelic
Lashay	Calkins
Shannan	Lombard
Justa	Razo
Jami	Fogle
Honey	Burkholder
Carmelita	Landers
Shelli	Crook
Vivan	Farias
Georgiana	Fairbanks
Maxima	Wheatley
Raymonde
Chas	Dupree
Cicely	Wellman
Latashia	North
Tiffani	Wallen
Berta
Ozell	Abraham
Shemeka	Parish
Aileen
Patrick	Doty
Mui	Bone
Neomi	Benavidez
Karon
Dee	Mcculloch
Stormy	Fulton
Lovie	Milton
Jonelle	Sisk
Eden	Poore
Caitlyn	Cordell
Abdul	Colburn
Jaleesa	Ralston
Roxie	Handy
Carter	Moniz
Darnell	Hammons
Winter	Dooley
Dagmar	Haney
Roxy	Vickery
Tinisha	Cota
Gertude	Trice
Kimberlie	Lake
Annita	Orosco
Maragaret	Wynne
Lavonna	Mclendon
Santana	Overstreet
Mikel	Vanhoose
Diedre	Crawley
Josef	Cato
Tory	Clancy
Yasmine
Shanel	Forman
Jesusita	Sparrow
Weston	Beale
Dick	Radford
Christiane	Hartwell
Sol	Gossett
Tashia	Burney
Wendolyn
Rodger	Gooden
Maribeth
Krystina	Ebert
Tawna	Lunsford
Myrtie	Boudreau
Ahmad	Ham
Gemma
Ciara	Breeden
Cyndy	Lefebvre
Slyvia	Saxon
Alessandra	Binkley
Denny	Mancuso
Garret	Rudolph
Janey	Tapp
Alethea	Alley
Crissy	Regan
Bernita	Stovall
Nubia
Leoma	Lundberg
Jaye	Hiatt
Antony	Corley
Leandra	Lara
Layla	Beavers
Stanford	Low
Jules	Wall
Alycia	Durant
Maybell	Mcqueen
Marlin	Salmon
Bertram	Roth
Milford	Corrigan
Lakesha	Sammons
Dannielle	Elrod
Agnus	Frias
Maida	Lemke
Desmond	Jameson
Ginette	Silver
Esteban	Castleberry
Kirstin	Newberry
Clair	Osgood
Andreas	Whitehurst
Jeanmarie	Noland
Vernita	Christianson
Tonie
Santo	Ivy
Sanjuanita	Houle
Rasheeda	Bentley
Titus	Melendez
Sydney	Vest
Jennell	Harley
Brittni	Bergstrom
Zenia	Mcgill
Saundra	Dickson
Amal
Tamie	Qualls
Chieko	Whited
Stacey	Shirley
Milly	Erwin
Lorinda	Ott
Lupe
Trista
Russel
Denisha	Buckner
Yuette	Gustafson
Kiera	Dayton
Eura	Huber
Samella	Spriggs
Newton	Culp
Lajuana	Altman
Frankie	Vo
Jamar	Baines
Raguel
Myrle	Almeida
Elvin	Lavender
Denny
Aretha	Beckman
Meggan	Ponce
Sherika	Osburn
Nila	Moen
Jenice	Vail
Charles
Delpha	Oswald
Faustina	Pfeifer
Georgeanna	Pointer
Rolland	Wang
Lai	Kane
Lorenza	Medley
Lin	Finney
Chung
Anamaria	Pickens
Cindie	Cates
Jacquelin	Melton
Lucretia	Paine
Vernia	Xiong
Ressie	Behrens
Easter	Wiley
Norbert	Crosby
Kaylene	Walter
Kristofer	Hutchens
Junita
Britni	Creel
Joane	Rossi
Florinda
Dorathy	Thornhill
Demetra	Ulrich
Bev	Linton
Louanne	Held
Daron	Hallman
Mitzie	Machado
Brady	Richter
Latricia	Urbina
Claudine
Elly	Irish
Alona	Sommers
Ashleigh	Lawler
Lenita	Kendrick
Clementine
Kendrick	Echevarria
Darlena	Sikes
Flo	Elliot
Tenisha	Diamond
Kasie	Devine
Alane	Atwell
Ronnie	Jolly
Talitha	Waite
Waylon	Springer
Jacquiline	Shapiro
Young	Bradbury
Mariel	Schroeder
Gay	Samson
Shanda	Beam
Marybelle	Earley
Johnetta	Aranda
Aletha	Tolliver
Retta	Lay
Temika	Lemons
Clorinda	Seay
Yon	Roach
Vince	Blythe
Eufemia	Solano
Cammie	Rowell
Jona
Brooks	Toro
Jeni	Spradlin
Nanci	Urban
Rebbecca	Power
Francina	Minor
Lise	Osorio
Juliette	Webber
Felecia	Mccain
Marylee	Lerner
Gricelda	Tribble
Hailey	Delatorre
Kelsi	Michael
Claris	Chapin
Darcel	Colbert
Ai	Rutledge
Tyson	Potts
Ashanti
Joesph	Lowman
Lacresha	Spicer
Violette	Bachman
Ara	France
Lyda	Brumfield
Briana
Allen
Shenita	Foss
Giuseppina	Robert
Shanice	Muir
Ilene	Clevenger
Lauretta	Gauthier
Brain	Dorman
Kandi	Mcmillian
Alden	London
Nyla	Garnett
Penelope	Selby
Jerri	Hood
Kenya	Adame
Laine	Gregg
Damien	Griffis
Delorse
Jordon	Dumas
Regena
Shemika	Kramer
Marketta	Mcfarland
Virgen
Maryln	Oconnell
Racquel	Switzer
Mozell	Keeton
Lilliam	Denney
Jaimie	Correa
Anjanette	Barajas
Ronni	Krieger
Tomi	Shockley
Kirby
Sandi	Kincaid
Carina	Tanner
Deon
Keitha
Josefine	Hutchings
Leonarda	Sharpe
Louetta	Waterman
Manie	Glynn
Portia	Bussey
Kathe	Bowles
Danna	Cordero
Barbar	Slone
Nathanael	Valencia
Joye	Gatlin
Dalila	Johansen
Caroyln	Guillen
Willetta	Fine
Karie	Cantrell
Lenard	Babb
Eda	Rasmussen
Serafina	Beal
Kazuko	Kimbrell
Renna	Lima
Soila	Kohn
Kizzie	Wilt
Joya	Halstead
Fabiola
Mitchel	Beard
Maire	Schofield
Isadora	Wallis
Lupe	Schuster
Princess	Krebs
Monika	Conners
Marlo	Marx
Bernie	Short
Dino	Stull
Ninfa	Dennison
Mistie	Carey
Olen	Higgs
Vennie	Langley
Noe
Allyson	Crocker
Adelaida	Kessler
Kizzy
Tarsha	Mullin
Fawn	Marr
Merlin	Hope
Yael	Martins
Trinidad	Ibarra
Chelsie	Wu
Katrice	Parr
Jonie	Neely
Delphine	Kearney
Hee	Gillis
Sade	Bogan
See	Wagoner
Alene	Vandyke
Lakita	Fuqua
Loma	Gaskins
Coralee	Hong
Octavio	Hurt
Elfreda
Alia	Clements
Luise	Kohl
Madeleine	Dunbar
Suanne	Grigsby
Suzan	Helton
Samual	Drayton
Odelia	Cosby
Lorie	Conyers
Johnna	Mcwhorter
Georgine
Walton	Coyne
Dionne	Bivins
Delmer	Thibodeaux
Alex	Victor
Wilburn	Ennis
Melynda	Kay
Dalene	Elam
Sang	Bohannon
Torie	Arias
Louisa	Thayer
Camila	Womack
Stephani	Irving
Marcene
Cedrick	Tillman
Candance	Draper
Toi	Scruggs
Tomoko	Moses
Chandra	Goss
Candyce	Starks
Edelmira	Lyman
Anton	Riggins
Joseph	Mcalister
Chia	Guillory
Mckinley	Stoddard
Hayden	Flemming
Leanne	Nunley
Cordell	Colwell
Gertha	Chow
Tennille	Crane
Celestine	Galindo
Brandon	Prichard
Ema	Crabtree
Minna
Olimpia	Addison
Ali	Peck
Roseanne	Burks
Hanh	Bills
Mervin	Jernigan
Tandy
Ricarda	Hazel
Phoebe	Finley
Zachariah	Krueger
Milagro	Harman
Leonia
Amparo
Zelda	Yeager
Leif	Denny
Saran	Peek
Maricruz	Barnette
Laurine
Lavette	Mortensen
Paulita
Palmer	Fredrickson
King	Littleton
Yolando	Barr
Willian	Buckingham
Sunni	Hutto
Wei
Salina	Friedman
Johnson	Langston
Dina	Mcvay
Earnestine	Maier
Galen	Parnell
Loise	Shuman
Haley	Medeiros
Hollis	Law
Xuan	Burk
Lorretta
Lizzie	Brennan
Myrta	Cody
Deja	Bivens
Brigitte	Dove
Gwenn	Villareal
Joslyn	Murdock
Edyth	Mackie
Annika	Seymour
Tamatha	Downing
Bee	Vanmeter
Alvina
Augustus	Swift
Lupita	Hibbard
Jacquelyne	Ha
Randi	Loper
Marcelino	Lemus
Marlyn	Nelms
Mellissa	Macias
Alisa	Phan
Rickie	Choi
Wendie
Rossie	Mancini
Delmar	Mosher
Chelsey
Aurea	Ashmore
Celena	Button
Mila	Alston
Dillon
Hayley	Hanks
Lucilla	Mallory
Avery	Knowles
Torrie	Rowland
Refugia	Deluca
Willene	Elizondo
Ellis
Felice	Schreiber
Raina
Ellie
Lina	Cagle
Jeffie	Whitehead
Shawanda	Robles
Mignon	Latimer
Elton	Darden
Lavon	Valles
Nicolle	Elkins
Cori	Royal
Fern	Falcon
Lachelle	Shepard
Kathryne	Ayala
Pamila
Deloise
Yahaira	Sisson
Sharan	Pulido
Lonny	Bartholomew
Kena	Upshaw
Lilliana	Belanger
Jospeh	Eaton
Lucila	Buffington
Yen	Silvers
Margery	Smart
Tasia	Rand
Royce	Casteel
Raleigh	Roe
Ashley	Westbrook
Lottie
Haydee	Stahl
Marquerite	Roby
Denae	Kinsey
Fe	Whitten
Marylin	Trent
Contessa
Hung	Lytle
Kymberly	Cleary
Lael	Mccutcheon
Kenneth	Daily
Heide	Dow
Keisha	Rosser
Fermina	Kong
Gaynell	Mccombs
Blossom	Spurlock
Willette	Snodgrass
Jene	Newby
Willy	Metzler
Jamey	Rosen
Georgianne	Lemay
Rolf	Tillery
Ayanna	Stauffer
Avelina	Cash
Maryrose	Deleon
Gracia	Marcotte
Sarita	Tejada
Bobby	Cady
Sid	Furman
Leena	Koontz
Cristen	Heredia
Jesusa
Marceline	Perales
Loreta
Elodia	Counts
Shirl	Niles
Ruthanne
Sheryll	Word
Ned	Brinson
Alfonzo	Huynh
Caitlin
Carie
Deana	Groce
Kathaleen	Linkous
Denver	Caruso
Chau	Bottoms
Lanie	Berryman
Laverne	Leclair
Andra	Leal
Stephen	Joyce
Talia
Song	Doe
Arlen	Busch
Ward	Strunk
Janelle	Childers
Deedee	Huskey
Arcelia	Knott
Marisela	Coughlin
Toshiko
Florentino	Manzo
Alda	Schubert
Mollie	Masters
Man	Heard
Kacy	Bourque
Yuriko	Ginn
Cameron	Mcmahon
Jung	Mcswain
Yoko	Brower
Dyan	Tilley
Shani	Samples
Kasey	Cho
Lavada
Gerald	Quintanilla
Margart	Scholl
Cherry	Banuelos
Graig
Karyl	Boston
Melany	Mercado
Myung	Dupuis
Almeta	Mcneal
Marcell	Evers
Palmira
Kelle	Ewing
Latanya	Bratcher
Johnathon	Putman
Un	Stamps
Aleen
Reyes	Irizarry
Adrien	Ashcraft
Clarinda	Purvis
Clemente	Yanez
Amada	Mcdaniels
Deadra
Hildegarde
Latosha	Riggs
Jenee	Streeter
Shenika	Matos
Sang
Tabatha	Foret
Thomasine	Myrick
Johanne	Stein
Marci	Dobbs
Dusty	Oldham
Caryl	Palacios
Major	Lapointe
Maple	Blackmon
Loan	Mcclanahan
Melina
Sabina
Cinderella
Blanch	Bach
Mayra	Dube
Mozella	Roller
Tori	Dawkins
Melvina
Margaretta	Andersen
Vivienne	Ratliff
Taren	Bonner
Arnoldo	Criswell
Yung	Hammett
Usha	Ricketts
Genny	Baer
Sona	Vidal
Lidia	Mathias
Rosaline	Gallardo
Latonya	Segura
Val	Akins
Yukiko	Wyatt
Fay	Flanders
Carey
Haywood	Timmons
Gus	Sides
Rikki	Grossman
Scotty	Keene
Hedwig	Cope
Hettie	Moffitt
Malik	Paige
Teresita	Kruger
Anette	Acevedo
Dewayne	Mayer
Kati	Arroyo
Beata	Durbin
Blair	Covey
Han	Parham
Brinda	Baughman
Demetrius	Garrison
Love	Hartley
Polly
Reba	Hodgson
Lorrie	Thiel
Beverley	Alarcon
Yasmin	Crespo
Florrie	Minter
Artie	Doan
Tamiko
Winford	Woodcock
Tomiko	Herzog
Ruthie	Mccaffrey
Ok	Benjamin
Calista	Kowalski
Natashia
Jeffry	Hughey
Denice	Somers
Arlette	Jeffrey
Jerlene	Jansen
Kimberley	Oliphant
Zoila
Renata	Royer
Gearldine	Boatwright
Versie	Waldron
Augusta	Mcleod
Juliana	Baca
Bruna	Ho
Cassaundra	Dellinger
Eulalia	Griffiths
Cathryn	Morrill
Zonia	Kirk
Denisse	Pape
Lavelle	Schumacher
Leon
Faustino	Scales
Chantay	Broyles
Buster	Aiello
Gladis	Grantham
Elke	Skinner
Hortensia	Graf
Ellyn	Salisbury
Sigrid	Velazquez
Isa	Bostic
Charlyn	Engle
Piedad	Bader
Michale	Gandy
Enid	Humphreys
Chante	Reiter
Agustin	Lind
Aubrey	Menendez
Maranda	Basham
Shonna	Ojeda
Matha	Yoon
Alissa	Dudley
Ehtel	Ripley
Alyce	Berger
Riley	Rico
Monty	Cervantes
Zoe	Mcgrew
Rosy	Meadows
Erline	Gifford
Nana	Bond
Eldridge	Causey
Leila	Delossantos
Reinaldo	Grier
Debi	Wimberly
Nenita
Barrie	Weinstein
Chase	Mcgrath
Gretta	Pugh
Lesley	Horvath
Many	Pulley
Lamont	Andre
Telma	Culbertson
Antione	Mckee
Armandina	Blodgett
Annalee	Costello
Tiffanie	Upton
Numbers	Zeller
Melony	Israel
Araceli	Puente
Aron	Sloan
Magdalene	Dailey
Renate
Zane	House
Dimple	Mcgovern
Cathi	Milam
Retha
Demetrius	Zeigler
Serita	Gilliam
Rochel
Prince	Peyton
Phillis	Snowden
Merlene	Sallee
Beatriz	Edge
Vallie	Whatley
Page	Rapp
Corine	Hardison
Stefan	Battaglia
Christel	Easterling
Bettye	Oaks
Hilde	Bauer
Addie	Holbrook
Karmen	Dutton
Bridgett	Ly
Halina	Mcreynolds
Kenton	Lamm
Trenton	Mcgowan
Dortha	Jack
Alecia	Tierney
Joie	Bock
Terrell	Moreland
Tisha	Felix
Rosalee	Voss
Bethann	Ahmed
Penni	Cone
Oma	Mackey
Marguerita	Dugas
Erwin	Chase
Lourie	Wadsworth
Stefanie	Ambrose
Rosita	Drummond
Freeda	Mccullough
Carmon	Boyce
Gaston	Barraza
Jesica	Simonson
Jodie	Fortin
Lieselotte	Ware
Crystle	Pendleton
Vaughn	Christian
Sena	Gil
Vincenzo	Batten
Marcelo	Liles
Kasi	Lundy
Ethan	Britton
Siobhan	Grooms
Aiko	Nolan
Amira	Batchelor
Erlene	Lacroix
Laraine	Zepeda
Burma	Sadler
Lulu	Tompkins
Linh	Lear
Demarcus	Augustine
Lelia	Adler
Argelia
Tennie	Beauregard
Jon	Plunkett
Lucile	Settle
Melodi	Khan
Stacia	Baylor
Tawanda	Clemons
Lashawn	Sizemore
Geraldo	Dodge
Amalia	Rangel
Ilse	Lemon
Forest
Rosendo	Ledesma
Noelle	Leung
Ping	Hardin
Destiny
Jaymie	Fellows
Kyla	Good
Buddy	Weir
Kathi	Mchenry
Zina	Blaine
Rosario	Escobedo
Kittie	Otis
Dessie	Bess
Lissette	Malloy
Anitra	Klinger
Marry	Byers
Charlesetta	Lomax
Anastasia	Diggs
Daniella	Schuler
Emelia	Fanning
Alvera	Redden
Charis	Levesque
Leopoldo	Wasson
Tambra	Pressley
Nydia	Doran
Cortney	Stoll
Astrid
Barrett	Numbers
Estella
Misti	Swann
Rubi	Griggs
Michel	Forsythe
Veola	Bunch
Cherly	Denton
Gilma	Robins
Helaine	Kunkel
Ela	Seaman
Lakeesha	Keeling
Mavis	Keys
Davis	Brent
Elaina	Joiner
Ray	Maynard
Tish	Liu
Stanton	Hare
Brett	Mcmahan
Ronny	Stark
Agustina	Dyson
Tyler	Rodrigues
Marquita	Mcmillen
Mellisa	Crain
Reynalda	Doughty
Tam	Flaherty
Velvet	Barbee
Reggie	Connell
Will	Peeler
Sixta	Hayward
Sibyl	Alfaro
Ranae	Cochran
Eun	Mckenney
Gita	Omalley
Norah	Sanford
Robt	Rupp
Ileen	Drury
Lesha	Sherwood
Albina	Zapata
Codi	Ruth
Aleshia	Braswell
Pamella	Troutman
Soledad	Hidalgo
Sherley	Oleary
Alba	Block
Lashawna	Angulo
Libby	Christiansen
Omer	Braden
Charmaine	Weiss
Cami	Boland
Krishna
Grazyna	Whitworth
Na	Conklin
Harrison	Rickard
Otto	Dupont
Anibal	Rosenbaum
Bryon
Hoa	Thomson
Nelia	Hackney
Shena	Caswell
Melodie	Ontiveros
Georgetta
Devorah
Majorie	Levy
Blaine	Luce
Brenna	Denham
Perla	Gilliland
Leone	Couture
Maryanne	Hanley
Sirena	Tuck
Basilia	Hawes
Bernardo	Whitfield
Kandy	Kiefer
Staci
Carmel	Alves
Ashli	Scanlon
Lala	Mull
Lorita	Spellman
Mei	Faulkner
Arlyne
Santos
Adeline	Marroquin
Jeneva	Hardwick
Roselle
Marissa	Dang
Jessi	Anglin
Cheryll	Vu
Timothy
Sparkle	Conger
Shantell	Jenson
Caren	Camarillo
Cassy	Cramer
Angella	Wilks
Diedra	Bullock
Steven	Farr
Winona	Mundy
Paul	Bermudez
Emmanuel	Haggerty
Alita	Petersen
Gaylord	Capps
Trish	Devito
Cathey	Mcinnis
Evangeline	Dobson
Ty	Batiste
Barbie	Ma
Jolanda	Embry
Marquis	Galbraith
Desire
Kristian
Billy	March
Millicent	Morrissey
Ambrose	Killian
Jeffrey	Thorton
Fiona	Schilling
Silas	Paredes
Anderson	Engel
Twana	Weatherly
Agripina	Carbajal
Claudie
Chiquita
Odis	Coe
Augustina	Bragg
Karly	Haugen
Jerold	Chang
Toya	Whitlow
Buford	Pinkston
Henriette	Albert
Elvis	Halverson
Dorothea	Palma
Jodee	Binder
Sofia	Church
Quiana	Parent
Bonita	Clegg
Jerilyn	Mulligan
Isobel	Hinojosa
Dulcie	Poe
Jacinda	Seitz
Randa	Teel
Mirtha
Angle	Fontaine
Norman	Ferry
Mandi	Laster
Ethelyn
Margorie	Peoples
Darline	Kurtz
Winnie	Yount
Yuonne	Apodaca
Lissa
Darcie	Knudsen
Antonietta	Goins
Terina	Mock
Glady	Witt
Adella	Marquez
Sherly	Reyna
Raisa	Chalmers
Charlie	Dozier
Debera	Tapia
Melaine	Land
Mica
Krysta	Bolton
Alana	Cherry
Shantae	Fiore
Velva	Osullivan
Leandro	Lovelace
Porter	Brantley
Kyle	Rafferty
Elissa	Holloman
Iliana	Bowens
Hassan
Domenic	Hamblin
Keenan	Gaffney
Maricela	Mauldin
Dante	Payton
Leda	Chapa
Roseanna
Rosamond	Arreola
Gil	Negrete
Shante	Turney
Reena	Sherrill
Maye	Kolb
Tommye	Horn
Mirta	Hynes
Tonette	Lessard
Romaine	Stiltner
Bari	Werner
Soraya	Mccracken
Jerica	Sperry
Rosanna	Vazquez
Dong
Jame	Dill
Alysha	Corbett
Shellie	Beasley
Donn
Mittie	Zhang
Rayna
Junie	Vitale
Lory	Carswell
Broderick	Kilpatrick
Ashlee	Herrmann
Catarina	Pierson
Garnet	Fielder
Ophelia	Ferris
Susanna	Redmon
Angele	Salgado
Treena	Will
Clarissa	Priest
Assunta	Treadway
Daphine	Spain
Zola
Norris
Merrilee	Bozeman
Lizbeth	Hogg
Martine	Harp
Shanti	Ault
Rolanda	Oates
Hermine	Crittenden
Jasper	Galvin
Cathrine
Marica	Callender
Jenine	Stock
Neely	Woo
Carmella	Correia
Kaleigh	Garmon
Parthenia	Lombardo
Alexandria	Holder
Eliza	Tyson
Brigida	Burris
Tawny	Matney
Waldo	Heckman
Dario	Nicholas
America	Pruett
Jere	Bourne
Sammie	Peebles
Lianne	Pritchard
Mardell	Harlan
Brunilda	Schmid
Pearly	Rodrigue
Abigail	Goldstein
Maud	Deal
Marylouise	Baron
Edwardo	Gladden
Reita	Rubio
Valentine	Peak
Bret	Gary
Blake	Oconner
Lauri	Bumgarner
Holley	Guenther
Clyde	Barham
Millie	Julian
Manda	Rankin
Jeremy	Turk
Thalia	Abrams
Shaniqua	Marin
Dani	Lofton
Jovan	Bolling
Abbie	Mccollum
Inger	Sheets
Jackqueline	Royster
Michal	Cullen
Yuk	Winters
Karren	Denning
Daryl	Parris
Ruthe	Slocum
Julissa	Clawson
Teodoro	Charlton
Valentin	Strong
Shirley	Luciano
Williemae
Estela	Starr
Edgardo	Jolley
Julene	Ackerman
Aleisha	Meade
Meridith	Free
Myriam	Crider
Taisha	Lehmann
Darell	Carrion
Tereasa	Lu
Ursula
Lolita	Tyree
Charisse	Snead
Ilona	Hulsey
Carolynn	Tennant
Chanda	Enriquez
Shana	Snider
Malisa	Chisholm
Fran	Perryman
Ernie	Shields
Shavonda	Speed
Enola	Wilburn
Vannesa	Mccann
Macy	Mccrary
Maris	Peeples
Waneta	Chong
Minh	Waddell
Miki
Arletha	Hoover
Werner	Mccarter
Isabelle	Darby
Emil	Borden
Estrella	Pino
Valencia	Couch
Vashti	Mora
Ngan	Neel
Bella
Minh
Elizbeth	Schrader
Hien	Pepper
Lea	Larsen
Elza	Swartz
Jewell	Foley
Cyndi	Damico
Edra	Mattos
Matilde	Delong
Kerri	Gentile
Anjelica	Kaufman
Jayna	Dowdy
Alexa	Marchand
Royce	Gibbons
Jaqueline	Irby
Yolonda	Palumbo
Brigid	Hitt
Armand	Salcedo
Romana	Solomon
Yan	Guy
Luba	Luckett
Gerry	Rooney
Annett	Lemmon
Dominga	Yi
Senaida	Whiting
Nan	Witte
Dovie
Sung	Frazer
Emile	Mcdowell
Son	Haines
Marilu	Mcwilliams
Yi	Barron
Odette	Hutcheson
Lashandra	Mcdermott
Hilary	Harding
Lyla	Earls
Donya	Shelby
Danette	South
Danial	Mccune
Queen	Kaplan
Sam	Kruse
Minda	Talbert
Viviana	Andrade
Linette
Nereida	Ragsdale
Vanna	Savoy
Wally	Pringle
Izola	Forrester
Malcom	Dunham
Brittney	Olsen
Stephaine	Smoot
Arianna	Falk
Micah	Flagg
Angelena	Worley
Diann	Jorgensen
Tera
Cherie	Bunting
Yolande	Benner
Lera	Stine
Joana	Nieves
Cleo	Troy
Cherelle	Nagel
Ezequiel	Lash
Imogene
Dwain	Dowell
Tesha
Sun	Swank
Celeste	Olivarez
Buck	Templeton
Jannet	Simms
Lara	Hastings
Benton	Sumpter
Patrina	Easton
Linn	Romo
Olin	Gore
Altha	Burchfield
Gertie	Najera
Grisel	Ellington
Sheron
Nam	Saylor
Maude	Mcmaster
Christopher	Mcdonough
Nikole	True
Althea	Cutler
Coretta	Blackman
Isabell	Jordon
Lecia	Borges
Daniela	Jarrett
Amee	Withers
Romeo	Villanueva
Nakita	Wahl
Johnie	Bradshaw
Wyatt	Irwin
Verona	Huerta
Nada	Leyva
Victor	Ramey
Margarette	Bisson
Laverna	Lauer
Tilda	Busby
Mayme	Mccool
Caroll	Sprague
Hassie	Russ
Audrie	Major
Terica	Shaffer
Taina	Brunner
Britta	Archibald
Adela	Sigler
Gia	Colley
Drucilla	Whitmire
Lyndia
Precious	Ahrens
Louie	Stroud
Laure	Peter
Almeda	Jessup
Kindra	Case
Gabrielle	Pond
Sharen	Howland
Sherlyn	Eng
Carin	Otoole
Alfredia	Tripp
Tanika	Booker
Mora	Ludwig
Latina	Frame
Willena	Rockwell
Rosalyn	Muse
Vita	Samuel
Carmela	Watters
Keven	Ruffin
Teofila	Staley
Parker	Fairley
Ozella	Goodrich
Brigette	Pedersen
Enriqueta	Guest
Curt	Kimbrough
Rheba	Mabry
Jen	Passmore
Michiko	Dale
Delphia	Tracy
Kamilah	Gass
Sebrina	Ramon
Meaghan	Isaacs
Dan	Bourgeois
Rosella	Hanlon
Coreen	Dorn
Frieda	Mabe
Providencia	Goldberg
Katina	Roldan
Rueben	Aragon
Ebonie	Cheatham
Augustine	Sargent
Delora	Tijerina
Jalisa	Lacey
Kaitlyn
Miss
Jamison
Margeret	Burchett
Evan	Pyle
Carlita	Grissom
Shanta	Bellamy
Asuncion	Blankenship
Norine	Bello
Ta	Horsley
Akiko	Sandlin
Tresa	Rainey
Sasha	Escobar
Latia	Earl
Estefana	Williford
Lanny
In	Phelan
Yong	Leake
Nieves	Packard
Divina	Jarrell
Tamisha	Crockett
Hallie	Brittain
Gertrudis	Greiner
Linnea	Kemp
Erasmo	Connors
Sonny	Lackey
Meda	Desantis
Eugena	Clay
Kum	Echols
Sunday	Fish
Tanner	Hershberger
Stevie	England
Wilmer	Worthy
Daina	Duong
Britt	Friend
Kelley	Lockwood
Bernadine	Whiteside
Brianna	Mooney
Ali	Steiner
Sherrell
Apolonia	Lindberg
Malika	Pearce
Meri	Metzger
Nguyet	Mena
Dorian
Devin	Shore
Ettie	Winter
Robby	Dehart
Wilhemina	Mcnair
Herschel	Findley
Missy	Gold
Mayola	Sheridan
Heidy	Kovach
Ossie	Baxter
Jessia	Townes
Melia
Lauran
Dreama	Eggleston
Janita	Garvey
Syble	Doss
Jeannine	Canales
Verlene	Markley
Ellsworth	Stowe
Jeromy	Knoll
Minta	Mcknight
Candis	Himes
Foster	Roush
Royal	Duggan
Kaye	Stanfield
Savannah	Cooke
Ariane
Macie	Schmitt
Shawnda	Cowan
Kennith	Mattson
Vernie	Mcvey
Nery	Estep
Sheree	Whittaker
Nga	Vernon
Margy	Laird
Amado	Aleman
Wesley	Cordova
Adelaide	Locke
Keva	Magee
Brendon	Comstock
Marine	Hudgens
Shantelle	Merchant
Liz	Ellison
Bebe	Sowell
Lewis	Totten
Tarah	Trammell
Elia	Lowry
Maximina	Boisvert
Cathleen	Nunes
Cheyenne	Christopher
Quyen	Ives
Oren	Guinn
Sadye
Thomasina	Seal
Nichol	Slaton
Kyong	Eller
Arminda	Fitts
Zackary
Luanna	Longoria
Lauren	Joe
Lore	Aaron
Jena	Macdonald
Enda	Trotter
Landon
Nicki	Hamrick
Danyelle	Moon
Librada	Sears
Burl	Esposito
Chrystal	Alford
Lorelei	Ostrander
September	Begley
Micah	Davenport
Glennis	Mckinnon
Noreen	Oconnor
Lynwood	Beltran
Joshua	Manns
Roseann	Hannah
Ila	Orourke
Herlinda
Maybelle	Oneil
Rosalia	Lucero
Tia	Barone
Gennie
Mika	Breen
Logan
Lekisha	Pina
Doreatha	Kimble
Synthia	Rizzo
Elouise	Bigelow
Carlee
Leisha	Fryer
Kellye	Prado
Shondra	Gamboa
Charlott	Council
Mana
Treasa
Gianna	Watt
Kathyrn
Murray
Fairy	Hyatt
Palma	Gaylord
Sherrill	Deloach
Elana	Alonso
Narcisa	Beach
Louann	Her
Angeline	Bordelon
Star
Terresa	Li
Mia	Ponder
Voncile	Mcclellan
Deneen	Craft
Monserrate	Milner
Kathey	Mansfield
Loreen	Chesser
Lashon	Strauss
Tyrell	Corcoran
Jerrie	Sturgill
Bennie	Guyton
Lashawnda	Boyer
Hai
Hiram	Fong
Hal
Bradly
Damaris	Mclemore
Del	Baptiste
Karl	Banda
Darcey	Ammons
Lakisha	Noe
Luci	Moye
Darwin	Noyes
Delilah	Randle
Torri	Starkey
Luna	Burrows
Loriann	Briseno
Trisha	Battle
Dione	Rohr
Troy	Goble
Rayford	Pennell
Merle	Staggs
Noella	Arce
Justin	Wicker
Williams	Vickers
Berry	Bayer
Christen	High
Stacie	Herring
Colby	Chance
Tatiana	Donaldson
Darron	Dees
Nakia	Seymore
Roxana	Aquino
Leslee
Ligia	Bedard
Carrol	Barnard
Rudolf	Clemens
Joycelyn
Elenore	Callahan
Madaline	Woodworth
Nickolas	Fulmer
Lona
Kaylee	Worrell
Orpha	Flannery
Hyon	Meeker
Luella	Hendricks
Yee
Somer	Haller
Adell	Caraballo
Dell	Leary
Lizette	Pollard
Donette	Winslow
Marivel	Steel
Christiana	Trimble
Alanna	Barry
Mark
Clare
Joella	Headley
Daniell	Mcfarlane
Ashely	Hawley
Ola	Wayne
Adelia	Benedict
Sharice
Bobette	Wilkinson
Wenona	Hardesty
Rosalind	Elmore
Reanna
Sylvie	Nye
Julienne
France	Barclay
Marx
Eulah	Barela
Lauralee	Metcalf
Treva	Creighton
Kylee	Bankston
Bettina	Calloway
Shandi
Carola	Agee
Robena	Madden
Salley	Cheng
Rory	Hurd
Signe	Dunning
Deeanna	Larue
Griselda	Kelleher
Hilma	Withrow
Leontine	Arsenault
Ronald	Valenti
Shawana	Gist
Adaline	Cowles
Pricilla	Taft
Colene	Leigh
Daisey	Kent
Eusebio	Hillman
Regan
Tijuana	Langford
Tracey	Tejeda
Sima	Lott
John	Bryson
Merna	Hensley
Rochell	Carranza
Thresa	Duvall
Sterling	Gardiner
Roxann	Nagle
Anglea
Kelsie	Lovell
Brittny	Mayers
Kieth	Southard
Carolee	Giordano
Cassidy	Centeno
Jenni
Lavonia	Heaton
Fredericka	Meek
Dottie	Dorris
Leigh	Kidd
Carri
Kimberely	Arndt
Nu	Hawthorne
Shelton	Bledsoe
Consuela	Becnel
Regenia	Carmona
Jammie
Hobert	Gillespie
Marlys	Cornelius
Jamel	Torrence
Louis	Satterfield
Inga	Legg
Rigoberto	Cabrera
Michal	Cerda
Gavin	Montanez
Denese	Epstein
Harland	Sneed
Debrah	Costa
Alva	Blackwell
Ula	Meyers
Deetta	Dye
Jann	Pendergrass
Loralee	Siegel
Carol	Renteria
Larue	Leggett
Kiara	Dubois
Cristie	Wick
Emogene	Novak
Junior	Rector
Katharine	Albrecht
Renay	Chau
Anabel
Jack	Varela
Delicia	Sweet
Spring	Whittington
Amberly	Shoemaker
Edda	Sexton
Sherrie	Kelso
Mazie	Geary
Claretha	Lattimore
Elwanda	Neumann
Shane
Malvina	Dempsey
Pamula	Wilcox
Risa	Burrell
Letisha	Florez
Dane	Hatcher
Arnita	Nix
Rebekah
Solomon	Faulk
Tamar	Crowley
Avril	Souza
Vincenza	Wolf
Zora	Reilly
Jennefer	Holliday
Noel	Waugh
Elease	Boucher
Teisha	Rowan
Pandora	Chin
Kyoko	Kraft
Pattie	Mize
Roslyn	Pham
Chris	Vincent
Margene	Lange
Stephane	Wilbanks
Onie	Heinz
Humberto	Huddleston
Rowena	Ledford
Vicenta	Odonnell
Catalina	Pederson
Lashaun
Starr	Buck
Katy	William
Clarita	Marble
Riva	Ison
Alla	Beane
Tressa	Richey
Isidro	Blunt
Clair
Sharron	Preston
Breann	Kinney
Isaiah	Matteson
Darby	Russo
Timika	Champion
Brice
Lashonda	Baumgartner
Deeann	Agnew
Fidela	Patino
Edythe	Schaefer
Dominica	Bruns
Lani	Vaughan
Carrol	Gaston
Rhona	Herman
Angeles	Mcmanus
Elmer	Person
Lawrence	Aponte
Verena	Landrum
Andria	Blakely
Magaly	Esquivel
Beckie	Hoskins
Dorine	Bliss
Antionette
Justine
Carli
Danae	Still
Dia	Haggard
Eleonor	Pace
Lemuel	Gallegos
Jarrett	Harkins
Genesis
Malissa	Moll
Emery	Corral
Willodean	Everhart
Shela	Corey
Vesta	Bayne
Renetta	Madrid
Tobi
Adelle	Biggs
Deirdre	Rushing
Eilene
Toby
Arlinda	Mcnulty
Josephina	Pelletier
Theola	Francisco
Ivana	Alderman
Jacquline	Malcolm
Eleanora	Stapleton
Emmie	Saucedo
Irina	Mcmullen
Lincoln	Vick
Malena	Moriarty
Darrick	Betts
Pierre	Sorenson
Hellen	Stanton
Nancee	Sander
Alaina	Martell
Jasmin	Carlos
Niki	Foust
Kerstin	Sales
Lavera	Tiller
Tanna
Deloris	Alba
Camilla	Mueller
Su	Cathey
Sunny
Mitsue	Ngo
Remona	Limon
Ming	Rawls
Daniele	Dahl
Chara	Gomes
Jannie	Blackburn
Myesha	Pineda
Ingrid	Cave
Lino	Roper
Shella	Whitney
Summer	Street
Bernardina
Katlyn	Treadwell
Arvilla	Viera
Freddy	Marquis
Loyd	Baugh
Diego	Sweeney
Cuc	Cano
Brittanie	Tang
Burton	Polk
Fatimah	Helm
Fausto	Weller
Carlie	Thomsen
Mariette	Andrew
Glory	Parrott
Darcy	Salas
Belle	Stiles
Nilsa	Beaver
Gaye	Mendenhall
Maya	Hildebrand
Leonida	Dollar
Nadia	Kahn
Lou	Whelan
Mitzi	Messenger
Petrina	Fusco
Alverta	Osteen
Audie	Camacho
Lester
Donnetta	Muhammad
Tania
Bree	Sepulveda
Dwana	Hester
Shu	Kraus
Margarete	Maas
Bart	Sturm
Hyman	Greenfield
Valeri	Dewitt
Aurora	Durand
Rosette	Lightfoot
Jennette	Cahill
Yun
Shirleen	Sell
Yvone	Zook
Annalisa	Bratton
Germaine	Rea
Kassie	Steffen
Marina	Jeffers
Deonna	Blum
Fred	Skipper
Sybil	Gladney
Coy	Davila
Kiersten	Hales
Willow	Brothers
Sari	Grayson
Aurore	Felton
Julio	Ritchey
Zetta	Whitlock
Hong	Cortes
Fletcher	Saenz
Shaunta	Avery
Yesenia	Nettles
Hulda	Triplett
Shamika	Rayburn
Otilia	Fullerton
Reynaldo	Seidel
Rich
Dennis	Kimball
Hui
Ryann	Finn
Suzann
Jong	Ashford
Julianna	Kunz
Pauletta	Boehm
Coralie
Rocco	Mcneil
Veronique	Tibbs
Janise
Cletus	Emery
Lawanda	Keith
Arletta	Parry
Lacy	Mclean
Bunny	Dyer
Tad	Candelaria
Dallas	Rider
Mendy	Humphries
Talisha	Adcock
Zachery	Escalante
Maxie
Kaila	Pruitt
Arron	Stitt
Stepanie	Wester
Arleen	Amador
Dion	Henley
Theda	Mccartney
Leanora	Feldman
Kenia	Padgett
Kareem
Clarence	Schulz
Rima	Benoit
Rashida	Molina
Tyron	Shea
Shae	Unger
Wiley	Hoyt
Mindi	Mcintire
Harley	Bagley
China	Eddy
Sindy	Wicks
Freeman	Morrow
Aracely	Grubb
Gwyneth	Chappell
Estell	Baez
Gabriel
Stephan	Coppola
Kirsten	Burkett
Consuelo	Wenzel
Randee	Varney
Laquita	Layne
Therese	Conaway
Marcellus	Rountree
Deandra
Delcie	Pate
Leanna	Sherrod
Linwood
Dakota	Nava
Hye
Santina	Bearden
Cruz	Richmond
Ivelisse	Malley
Karlyn	Gunther
Jenniffer	Pitts
Susannah	Larkin
Sacha	Thurman
Shonta	Mauro
Aaron	Slaughter
Kristal	Walston
Keneth	Haag
Vance	Sun
Bernarda
Boris	Rust
Markus	Back
Chan	Kitchen
Eric	Chester
Cleta	Heller
Leola	Hatton
Holli	Jaeger
Ericka	Tisdale
Frida	Sheppard
Tomasa	Poston
Jarvis	Dolan
Alline	Hemphill
Miesha	Picard
Dorthey	Drew
Elida	Judd
Deon	Tubbs
Tangela	Flood
Tiesha	Riddick
Samira	Shanks
Latasha	Fishman
Danilo	Seals
Tatum	Thurston
Octavia	Prince
Wynona	Parkinson
Malorie	Proctor
Kacey	Spring
Maximo	Bruno
Brenton	Foy
Leonila	Paradis
Fermin	Mayberry
Edris	Large
Shanita	Swafford
Virgina	Clifton
Johnie	Winchester
Kermit	Shorter
Conchita	Mount
Steffanie	Varner
Meagan
Abram	Delgadillo
Jeanine	Whitcomb
Chanel	Honeycutt
Shiela	Burch
Phuong	Meier
Kip	Trask
Ellamae	Farrington
Ester	Sam
Walker	Barbosa
Tamra	Greenlee
Hiroko	Valenzuela
Kathrine	Seiler
Peggie	Nutt
Monnie	Cary
Marin	Ring
Nedra	Matheny
Wilfredo	Mccloud
Buffy	Espino
Branda	Caron
Giovanni	Grimm
Joaquina	Mckenna
Tiara	Richard
Valrie	Jarvis
Jeanelle	Wofford
Jacalyn
Shirlee	Carder
Fernanda	Mccallum
Annetta	Fleck
Tequila	Dodson
Leonor	Ragland
Rivka	Epps
Collen	Foreman
Carlene	Napier
Tona	Frick
Joeann	Mcdougal
Shawnee
Santa	Sampson
Pearlie	Odom
Gena	Stephen
Sabine	Babcock
Mallory	Ridenour
Nelle	Chadwick
Klara	Close
Dean	Moe
Van	Arnett
Cinthia	Gilley
Leonel	Ridgeway
Ja	Harry
Rae	Huang
Winfred	Chastain
Tova	Guerin
Neville	Golden
Francesca	Waldrop
Dennise	Castellanos
So	Winn
Len	Shafer
Dorris	Caskey
Juliet	Pennington
Ewa	Hendrick
Clarice	Logue
Willia	Laflamme
Alfreda	Burleson
Sharleen	Braun
Miquel	Ness
Carmine	Kauffman
Hilario	Paris
Avis	Murrell
Lizabeth	Boggs
Chanell	Mccaskill
Claretta	Aiken
Candida	Carlisle
Cherilyn
Marcelina	Woodruff
Hank	Cartwright
Rhett	Mahoney
Krissy	Shipman
Carisa	Mcrae
Mikaela	Cobbs
Enoch	Redman
Christian	Chung
Jone	Carman
Abby	Willoughby
Jule	Cardwell
Jefferey
Eusebia	Coble
Danuta	Harden
Emiko	Mcgraw
Lakiesha	Blount
Florene	Brannon
Wilford	Turnbull
Reuben	Lindgren
Malinda	Cambell
Rob	Garvin
Maynard	Pollock
Gabriele	Shipp
Berneice	Bolt
Maryellen
Naoma	Shell
Mickey	Rhoads
Nilda	Bundy
Jolynn
Perry	Kang
Everette	Broadway
Shira	Purnell
Jonnie	Koonce
Renae	Nixon
Billie	Rounds
Cecily	Beattie
Herb	Raines
Shanelle	Quintana
Douglass	Prosser
Jeanna	Martz
Francie	Sands
Tabetha	Mangum
Mauricio
Georgette	Noble
Tory	Castaneda
Etha	Goforth
Anisha	Root
Jesenia	Mcpherson
Neda	Folse
Blondell	Soria
Cassondra	Okeefe
Brant	Smallwood
Yetta	Bittner
Jerrold	Newkirk
George	Milligan
Allene
Makeda	Lumpkin
Jin	Delacruz
Jina	Shephard
Dorthea
Rocky	Lowell
Agueda	Kee
Desirae	Layton
Loraine	Prather
Kaycee	Poland
Luanne	Spruill
Lue	Willett
Liberty
Edie	Montalvo
Marinda	Aldrich
Celina	Mackenzie
Odell	Huey
Joetta
Lane	Choate
Lucrecia	Childs
Brandee	Akers
Rosalina	Haskins
Sanford	Goetz
Maryetta	Wendt
Lorean	Huston
Selina	Archie
Alexis	Tobias
Victorina	Lund
Francene
Gale	Reichert
Lanell	Doll
Leota	Gagnon
Vernice	Crum
Mariano	Beauchamp
Tristan	Byrnes
Demetrice	Connor
Lenora	Kaye
Alisia	Getz
Yasuko	Halcomb
Hsiu	Stpierre
Dona	Broughton
Maryjane	Sena
Joette	Ng
Deandre	Metz
Evia	Pipkin
Roni	Forbes
Isreal	Shearer
Kimiko	Benitez
Jonas	Currie
Lakeshia	Patel
Cristine	Emanuel
Jade	Stubblefield
Frederic	Mccray
Edwina	Schulte
Idell	Toth
Garfield	Conley
Shakira	Zarate
Cruz	Lira
Keith	Salinas
Georgianna
Manual	Forte
Nigel	Lord
Tu	Furr
Shantay	Chan
Sherie	Hefner
Andrea	Cheek
Launa	Haskell
Inge	Trahan
Sharell	Talley
Berry	Downs
Joanie	Fulcher
Barbra	Gerard
Debbra	Boykin
Marisol	Wiseman
Fredda	Allan
Tracie	Koehler
Corrin	Kimmel
Chong	Espinal
Charlette	Thomason
Carolann	Navarrete
Carolin	Ferrer
Shanae	Hurst
Annamae	Freund
Shawanna	Janes
Arielle	Lopes
Marylynn	Keenan
Lilian	Crouse
Kayce	Coffman
Eleonore	Freitas
Elba	Brandon
Long	Gunderson
Evelyne	Askew
Inocencia	Utley
Annis	Galarza
Kerrie	Carden
Lakendra	Amaya
Myrna	Parrish
Alleen	Derr
Elin	Ferrell
Kassandra	Mcduffie
Terra	Vann
Dusti	Hwang
Karissa	Nance
Whitney	Fortune
Mozelle	Kinder
Christena
Beatris	Carrington
Marcel	Neff
Christene
Randell	Lantz
Pa	Titus
Xiomara	Mclaurin
Ayako	Trinidad
Fredia	Carnahan
Adolph	Nall
Nella	Shifflett
Lindsay	Gunn
Wanetta	Brockman
Casimira	Brandt
Annemarie	Danielson
Morgan	Stillwell
Renita	Olivas
Evie	Grenier
Annelle	Granados
Alexander	Mcfadden
Awilda
Nikki	Lamar
Irmgard	Littlejohn
Nita	Dietrich
Elda
Hildegard
Brian	Woodson
Nakisha	Stuart
Emmy	Florence
Roberto
Etta	Franks
Stan	Pullen
Gema	Mcintyre
Arla	Kiser
Dee	Dugger
Antonia	Gamez
Criselda	Lenz
Magdalen	Forney
Shawnta
Stefania	Head
Meryl	Lau
Jayne	Spears
Zita	Seaton
Elden	Belcher
Luciano	Rauch
Federico	Britt
Kirstie	Oakes
Kacie
Melisa	Dukes
Nelida
Gale
Alica	Shelley
Elsy	Worthington
Fleta	Stump
Bethel	Copley
Donny	Giron
Hyo	Fernandes
Evette
Hue	Fitch
Burt	Lance
Lessie
Delta	Lyles
Keren	Faison
Lovetta	Thrasher
Rosaria	Blalock
Catherina	Linville
Harriette	Battles
Simonne	Fajardo
Joe	Poulin
Necole
Jerrell	Reich
Kellee	Shinn
Sherron	Warfield
Lisha	Bauman
Clemmie	Arellano
Marlen	Everett
Shelby	Wentworth
Joline	Bonds
Eugene	Suarez
Golda
Davina	Goddard
Myrl	Esparza
Gaynelle	Labbe

Process finished with exit code 0

