Clyde	Moser
Devon	Cagle
Modesto	Gunderson
Lovella	Fortier
Marva
Nakisha	Galbraith
Modesta	Mott
Deirdre	Jolley
Danille	Macon
Jacki
Elin
Rebecka	Casteel
Arleen	Wooden
Pasty	Hare
Eliseo	English
Lashawn	Kyle
Randee	Lomax
Jannet	Batista
Sondra	Youngblood
Kathie	Fahey
Carlita	Ogden
Yi	Coles
Golden	Crum
Kendall	Kemp
Kenna	Vanwinkle
Adah	Kitchen
Sudie	Riddle
Vivienne	Kline
Julianna	Lassiter
Temika	Crandall
Emerita	Mcalister
Romaine	Brinkley
Marianna	Watt
Brigette	Hammett
Shella	Burnside
Luanne	Quintero
Elyse	Dix
Kary	Archer
Magaret	Funk
Art	Stitt
Emilia	Scroggins
Antionette	Zeller
Lavonna
Lashell	Garris
Dominica	Moreau
Nilda	Ramon
Flo	Danielson
Otha	Mcconnell
Garnett	Plummer
Carli	Tam
Jama	Lauer
Audie	Dupont
Merlene	Healy
Dewayne	Schell
Wilfredo	Frame
Marth
Jeanice	Baptiste
Dwana	Trent
Shirlee	Broome
Halina	Damon
Priscila	Mccune
Renetta	Masters
Kandace	Seymour
Sharen	Dooley
Keva	Hollins
Dorthey	Rockwell
Francesca
Oswaldo	Cardoza
Simona	Mcdonough
Necole	Nunn
Nelly	Silverman
Deeanna	Leblanc
Noella	Storey
Joellen
Alleen	Rock
Erin	Mcqueen
Charolette	Gladney
Michel	Nolan
Emerson	Patten
Celeste
Laquita	Graf
Izola	Brunner
Jed	Ma
Wally	Eggleston
Kenyatta
Bobbye	Pappas
Mozella	Dunaway
Mui	Ferrell
Wilford	Correia
Kaila	Phan
Cecila	Wingate
In	Link
Luetta	Coward
Thurman	Dortch
Evan	Osorio
Fredda	Tomlin
Wanetta	Burchett
Dayle	Alba
Branda	Haas
Sammie	Grace
Carolin	Mark
Randell	Kimmel
Aaron	Archuleta
Mohammed	Billups
Vince	Medley
Latashia	Hay
Bettina
Jen	Pritchard
Francie	Ridgeway
Lesley	Pimentel
Elna
Sulema	Foote
Ariel	Espino
Junita	Devlin
Odette	Royster
Barbar	Weatherford
Robt	Whitaker
Geraldo	Ruth
Lavonia
Dee	Peter
Etta	Randall
Beatriz	Handley
Lacy	Bannister
Richard	Mcnair
Herta	Jeffery
Elizabet	Grogan
Susannah	Laney
Keith
Loreen	Milliken
Iva
Renaldo	Warfield
Marry	Mooney
Adrianne	Baumgartner
Jolyn
Elma
Mariann	Maynard
Delila	Bottoms
Joey	Tyree
Nickie	Coons
Melissia	Atchison
Heide	Lutz
Delpha	Vazquez
Billi	Huffman
Racheal	Billings
Chang	Mclean
Rosaura	Weller
Melonie	Otero
Warner	Heller
Lizette	Hartmann
Carma	Story
Saturnina	Beaver
Margaretta	Gilman
Cyrstal	Knudsen
Altagracia	Conroy
Jettie	Sowell
Peg	Florez
Vena
Lynsey
Vina	Hendricks
Nicola	Denning
Trent	Heffner
Elayne	Sneed
Roxanna	Clifford
Mervin	Mcbee
Hortencia	Dietz
Darleen	Gentry
Genny	Waller
Kathryne	Mccorkle
Barb	Hollingsworth
Angila	Grenier
Stefan	Sutter
Sumiko	Vinson
Billy	Matheson
Danuta
Kizzie	Lowry
Vella	Jacoby
Allyn	Homer
Edie	Oneill
Carolynn	Mcmillan
Virgie	Ponce
Lonna	Levy
Clemmie	Partin
Roscoe	Lacroix
Germaine	Olivares
Marchelle	Spivey
Lavonne	Howerton
Racquel	Barajas
Buena	Vincent
Celesta	Almanza
Wynell	Koontz
Vashti	Dupree
Merlyn	Delong
Myesha	Upton
Kati	Redman
Abdul	Wampler
Lilly	Lawton
Delta	Joyce
Svetlana	Marino
Larhonda	Montes
Barrett
Keira	Mayes
Shenita	Goldman
Temeka	Bohn
Leigh	Thorn
Nova	Woody
Marisela	Montalvo
Sindy	Thorton
Young	Isaacson
Rema	Michael
Ollie	Tyner
Eleanore	Hutchison
Beaulah	Shafer
Laverna	Leroy
Delma	Lo
Carey	Withers
Veta
Lavern	Laird
Therese	Bess
Christiana	Langdon
Jordan	Shah
Erna	Gaskin
Rob	Talbott
Afton	East
Edward	Mccabe
Fernande	Crenshaw
Suzy
Marylou	Gatlin
Jerrica	Salcido
Deon	Dillard
Katherin	Borrego
Else	Tobin
Jovan	Conners
Rosanne	Upchurch
Denny	Jansen
Wanita	Gruber
Davis	Muller
Lili	Hamlin
Santa	Farrar
Newton	Herring
Miki	Washburn
Jaclyn	Osgood
Sunshine	Galvin
Enriqueta	Maurer
Treasa	Ault
Lashay	Wolford
Arlean	Dowling
Quintin	Medrano
Gracia	Hamrick
Ali
Lura	Trevino
Wilda	Caron
Kacey	Blackburn
Taylor	Dial
Lanelle	Gillespie
Casandra	Rousseau
Justine	Beauchamp
Andera	Hyland
Sheilah	Bergman
Luciano	Tripp
Ardelle	Cockrell
Sharla	Duong
Magdalene	Vanhoose
Jerrold	Cutler
Octavia	Oakes
Marielle	Coburn
Ami
Kandra	Addison
Jamel	Lester
Ciara	Winn
Cordie	Spence
Destiny	Flannery
Jaunita	Rossi
Giselle	Leavitt
Clarisa
Cythia	Zaragoza
Efren	Hayden
Amina	Crooks
Margarito	Conklin
Chanelle	Fielder
Hailey	Hedges
Fritz	Louis
Nicol
Chrystal	Cobbs
Elvie	Polk
Carolyne
Zena	Ragland
Cole	Feldman
Vida	Neel
Melani	Candelaria
Cortney	Wall
Hans	Costa
Paz	Gainey
Cheree	Fortenberry
Anthony	Prater
Catrice
Catherin	Hutchings
Sharyn	Jewell
Ethelene	Mcrae
Jann	Beebe
Man	Littlefield
Melony	Horvath
Concetta	Bunting
Cathleen	Gilley
Wen	Spaulding
Junko	Maness
Janee	Cone
Christopher
Isa	Ferry
Belia	Early
Kylee
Aleta	Putnam
Toney	Hatch
Tish	Osteen
Refugia	Wicker
Neomi	Loy
Crista	Rawlings
Samella	Shapiro
Elisabeth	Kemper
Madlyn	Glass
Sandy	Spriggs
Tad	Conover
Kathi	Bernier
Maybell	Mcfarland
Elza	Ladner
Lanora
Mariah	Salley
Caitlyn	Savoy
Celina	Neff
Rosalva	Sumner
Lenita	Solis
Raeann	Smothers
Bernetta
Doria	Renner
Janna	Redding
Sanjuana
Annemarie	Beckman
Mickie
Damion	Southern
Briana	Styles
Dannie	Haight
Renae	Naylor
Clair	Bean
Jena	Lovett
Solange	Jeffrey
Alva	Helms
Alpha	Reeder
Alanna	Blanchette
Rory	Poindexter
Carter	Burrows
Wilber	Hildreth
Johnna	Atkinson
Sean
Stephani	Christman
Maxwell	Dugger
Kerri
Tarra	Francisco
Shawanna	Bock
Luvenia
Pandora	Hinson
Tamesha	Trejo
Tonisha	Melton
Alene	Weston
Scottie	Deleon
Valentine	Satterfield
Vance
Deann
Ruthann	Pointer
Valencia	Jose
Karima	Nickel
Alejandra	Swenson
Idella
Zenobia	Mendenhall
Angelique
Cristal	Ames
Beckie	Willson
Josephina	Killian
Kiera	Kenny
Manie	Painter
Fran	Westfall
Tera	Whitworth
Tanesha
Tawana	Franks
Hayden	Shumate
Irwin	Kinney
Jennell	Button
Darcey	Pennell
Fae	Savage
Isis	Maestas
Suanne	Poirier
Nan	Shook
India	Marcum
Jesusa	Rhea
Garfield	Moses
Melynda	Tarver
Maddie	Reiter
Vanita	Mccartney
Shirley	Whitson
Georgiann	Keefer
Nilsa	Wilke
Joshua	Cosgrove
Shanel	Dejesus
Felisha	Langley
Genia	Danner
Karoline	Oneil
Jacelyn	Rowley
Katharyn	Colvin
Verlie	Martindale
Halley	Babin
Shasta	Magee
Emilee	Levin
Euna
Valentina	Pruett
Inocencia	Marble
Bernarda	Layton
Laronda	Haskins
Jackqueline	Whyte
Tashina	Whiting
Jacqualine	Renteria
Otilia	Ojeda
Loma	Curran
Annabell	Juarez
Mariella	Hodgson
Eulah
Gail	Franz
Alaina	Simms
Annabel	Branch
Georgina	Duff
Fiona	Bandy
Shantae	Chun
Neville	Lorenzo
Phebe
Randy	Jacob
Frankie	Griffiths
Bridgett	Barney
Twila
Cristy	Butterfield
Thanh	Click
Maren	Gabriel
Britni	Norwood
Aide
Rosina	Madsen
Sena	Lennon
Alaine	Atwell
Claudette	Nix
Elton	Starnes
Love	Eagle
Jolynn	Wharton
Sierra	Settle
Weston	Peachey
Hiroko	Zielinski
Yung	Hook
Roselyn	Almeida
Ahmed	Glaser
Sheba	Berrios
Shenna	Golden
Lue	Krauss
Wiley	Himes
Lida
Rashad	Gunn
Nicky	Orr
Tyrell	Desimone
Francina	Broadway
Keri	Calvert
Amie	Lipscomb
Anneliese	Mcneil
Lynelle	Dias
Tegan	Purcell
Jesse	Christopher
Divina	Huber
Jade	Brent
Lavera
Bonita	Dumas
August	Lockhart
Celestine	Grice
Nelia	Balderas
Zane
Vincenzo	Mueller
Rupert	Crow
Laureen
Sixta	Mcgill
Richie	Burden
Nikki	Serrano
Danita	Parrott
Layla	Gauthier
Anh	Rhoades
Leandra	Jarvis
Terresa	Chesser
Collin	Andersen
Lessie	Ng
Lisha	Dasilva
Annabelle
Parker	Swain
Chrissy
Cristie
Jene	Blankenship
Steven	Jacobson
Isabelle	Lowery
Kerstin
Olen	Sams
Mahalia	Tidwell
Bebe	Salgado
Nena	Swann
Chuck	Linville
Noemi
Skye	Fenner
Lawerence	Groves
Arnulfo	Fisk
Maile	Ponder
Ezekiel
Floria	Neil
Stephen	Barrow
Lianne	Vanmeter
Mario	Bourgeois
Zelda	Colbert
Anitra
Marilynn	Spangler
Antonia	Orlando
Cornelia
Melodie	Bowles
Blossom	Loftis
Ronni	Scherer
Alysha	Lowman
Maura	Aquino
Adolfo	Seidel
Amparo	Knapp
Aiko	Hartley
Eleonore	Kearns
Lashonda	Trice
Tayna	Brinson
Micha	Riggins
Cecily	Westbrook
Kasie	Drury
Mimi	Gustafson
Willetta	Mclemore
Laurene	Bruns
Tabetha	Pulido
Odis	Alonso
Torie	Ornelas
Karan	Burroughs
Cathern	Britton
Amira	Purdy
Christeen	Dobbs
Sanora	Meador
Barbie	Dunning
Leora	Braun
Elana	Blaine
Prince
Minta	Dent
Milda	Clough
Leola	Pfeiffer
Lulu	Cloud
Marianela	Gipson
Isreal	Harkins
Augustine	Keys
Chantel	Maloney
Mandie	Harter
Alex	Jessup
Venice	Leeper
Vivan
Dodie	Hooper
Bernita	Switzer
Leota	Hallman
Antonetta	Mercado
Belkis
Felicita	Barnhart
Vernia	Thorpe
Hsiu	Marchand
Pamala	Haines
Toshia	Ordonez
Lakendra	Gagnon
Lenore
Otto	Brower
Scott	Newberry
Jenette	Proffitt
Rocco	Leach
Ernie	Eastman
Rhea	Haggerty
Chung	Perron
Antoine	Farrow
Eleonor	Bradford
Page	Canfield
Shamika	Chilton
Rae	Hurt
Theo	Lankford
Eldridge	Taft
Aron	Conger
Audry	Held
Delois	Cowan
Cameron	Swift
Brenna	Thibodeau
Loise	Fulton
Ming	Vela
Ike	Butts
Mariano	Frasier
Maurita	Mccool
Ophelia	Mora
Violeta	Griswold
Alyce	Hays
Vanna	Mccaffrey
Chelsey	Derrick
Glady	Christian
Delmer	Worley
Joel	Leary
Lucile	Streeter
Nicolle	Novak
Apolonia	Beach
Lanie	Mock
Hannelore
Maida
Suzette	Light
Curt	Zeigler
Karlene	Trahan
Juan	Lake
Harris	Stern
Miles	Slocum
See
Hang	Diggs
Christal
Cherly	Mace
Maryland
Josue	Kroll
Phillis	Pitre
Pamula	Wiese
Sid	Chacon
Verla	Mello
Dione
Dorian	Pemberton
Clelia	Liu
Merrilee	Mayers
Karl	Boston
Nicholle	Bowling
Ellyn	Sigler
Herlinda	Reece
Lynwood	Whitcomb
Coretta	Orta
Donovan	Palumbo
Romeo	Ingle
Margorie	Duvall
Julianne
Latisha	Peralta
Grisel	Close
Rosario	Reedy
Myrtie	Major
Aline	Tackett
Jay	Carden
Chantay	Gaylord
Van	Pelletier
Yanira	Herrick
Cleta	Gallo
Krissy	Stratton
Domitila	Beaulieu
Clarine	Sherrill
Hilaria	Yamamoto
Porfirio	Zapata
Sherrell	Tubbs
Jackeline	Redd
Carlene	Yeager
Jesenia
Nickole	Holman
Lilla	Simone
Stephania	Carbone
Hong	Parry
Forest	Valerio
Marquerite	Silver
Denese	Mayberry
Anissa	Castaneda
Shu
Kasi	Staley
Ronna	Dunbar
Hassie	Bedard
Kirstin	Chen
Sydney	Cromwell
Anglea	Quinlan
Dot	Menard
Nikole	Hass
Dahlia	Fagan
Merle	Corbett
Althea	Reichert
Lauran	Hatcher
Claudie	Grimm
Lucrecia	Starkey
Gerri	Peeler
Meg	Nagy
Voncile	Way
Marhta	Sadler
Chana
Corinna	Biddle
Minh	Holder
Bertie	Tibbetts
Michelina	Selby
Chang
Earlie
Tanisha	Markham
Lieselotte	Christie
Delphia
Johnathon	Henson
Waylon	Eng
Coralie	Needham
Lynetta	Donovan
Valrie	Asher
Kanesha
Stormy
Vern	Michaud
Eve	Mayhew
Gaylene	Clapp
Catharine	Rawlins
Lilliam
Deon	Peek
Shaquita	Ferreira
Georgianne	Wilcox
Aileen	Burley
Tobias	Silvia
Shaunta
Val	Dennison
Danika	Heflin
Alia	Ramey
Lavada	Seaton
Marita	Lamm
Adena	Ashworth
Latoria	Barham
Leonarda	Sutherland
Kaleigh	Swan
Kindra
Chanel	Cato
Roseline	Rigby
Giovanni	Reilly
Dalton	Renfro
Adaline	Gresham
Arline	Woodley
Les	Varela
Lourie	Coates
Corrinne	Etheridge
Maurice	Hanks
Imelda	Crabtree
Berenice	Crist
Yee	Faison
Ping	Breedlove
Summer	Miner
Verlene	Falk
Danica	Coats
Birdie
Ila	Lovejoy
Ava	Kahn
Eryn	Hwang
Twyla	Donnelly
George	Beverly
Mabelle	Cisneros
Gracie	Hahn
Shaunna
Theo	Jeffers
Bula
Daren	Egan
Kathrine	Herman
Linh	Hathaway
Arminda	Guthrie
Thomas	Prichard
Delana	Fierro
Ray	Lister
Mardell	Barba
Janell	Carbajal
Myrtice	Velez
Elroy	Mcgraw
Matthew	Mcintosh
Keila	Traylor
Gerald	Maki
Luanna	Gerald
Mireya	Doherty
Odell	Demers
Jarod	Petrie
Buster	Coy
Kris	Thomson
Melaine	Mcmanus
Sigrid	Mckee
Crysta	Weinstein
Anjanette	Mcpherson
Dagny
Zonia	Gale
Krishna	Regan
Sheena	Hendrickson
Argentina	Maas
Lorriane	Mosher
Rosalee
Belva	Lenz
Deanne	Weddle
Lashawna	Chaney
Josie	Lofton
Julietta	Custer
Noel	Stacy
Soo
Nigel	Bartels
Tory	Almond
Karleen	Winfrey
Shantell	Stinson
Andreas	Mccutcheon
Gary	Hyatt
Johana	Mayo
Rico	Mena
Elia	Montano
Bruna	Drew
Rhiannon	Duval
Merideth	Wetzel
Xiao	Erwin
Chris
Joseph	Mcghee
Justin	Douglass
Cherelle	Rector
Tambra	Delgadillo
Bok
Tatyana	Bivins
Leeanna	Flagg
Rosette	Cady
Elfriede
Bernie	Hirsch
Rossie	Back
Ethelyn	Peebles
Shaneka	Harwell
Lavina	Rodrigues
Emmy	Hackett
Digna	Theriault
Angelika	Lockett
Jayson	Sanderson
Dudley
Shawnda	Ralston
Lisette	Bagwell
Rodger	Cooks
Tran	Currier
Abby	Hinds
Demetrius
Holley	Cave
Jasper	Lindsay
Macie	Alaniz
Lara	Blais
Margot	Mcmillian
Mellie	Cowley
Cherlyn	Tanner
Reid	William
Suk	Alford
Elouise	Mcdade
Dusti	Searcy
Shela	Colby
Makeda	Newby
Nancey	Muncy
Elden	Lorenz
Suellen	Coombs
Karina	Mull
Shayne	Abel
Elke	Fernandes
Raphael	Rocha
Nu	Zimmer
Reynalda	Fanning
Earle	Compton
Marlo	Justice
Keiko	Hoffmann
Augustus	Shifflett
Eveline	Ritchie
Nydia	Veal
Shizuko	Morrow
Kisha	Goforth
Terina	Holcombe
Jeanetta	Mcelroy
Chantelle	Leigh
Zofia	Oconnor
Kattie	Fairley
Leonel	Villanueva
Basil	Cromer
Bernardina	Handy
Donald	Stiles
Jesus	Oneal
Patrice	Carey
Albina	Krueger
Felipa	Paz
Leopoldo
Jenniffer	Scanlon
Donn	Drummond
Berta	Strain
Zenia	Bumgarner
Caridad	Raley
Esta	Molina
Bethanie	Sparkman
Mirta	Gerard
Sun
Solomon	Eaves
Keisha	Tennant
Lani
Riley	Lachance
Henriette	Hammonds
Bev	Blackwell
Graham	Rico
Cammy
Cody	Teague
Evangeline	Gantt
Piper	Guinn
Marin	Albertson
Krystina	Childs
Tiny	Estes
Fernanda	Benefield
Nikita	Bair
Shena	Stanton
Ladonna
Silva	Hardison
Madalene	Travis
Antonette
Scarlett	Herrmann
Enedina	Penny
Jonie	Blanton
Alida	Durant
Son	Pak
Rosana
Chery	Razo
Dori	Wooten
Dane	Keyes
Karin	Manns
Eloy	Yee
Lino	Marion
Magan	Darby
Vernice	Earley
Eden	Troy
Mel	Swisher
Tyesha	Bueno
Caryl	Sibley
Georgianna	Acker
Ilse	Daigle
Kazuko	Vogt
Kiersten	Knoll
Latrice	Shin
Dell	Gaskins
Adam	Beall
Hermila	Souza
Ivette	Bunnell
Betsey	Messina
Carlotta	Herrington
Brianne	Tiller
Eugenie	Forman
Danial	Calhoun
Carolann	Krebs
Kayce	Ferrer
Julee	Conti
Ingrid	Anders
Brynn	Barkley
Jenell	Moe
Joye	Olvera
Steffanie	Scholl
Ryann
Lissa	Milton
Taisha	Raney
Asa	Matheny
Iluminada	Prince
Florine	Cody
Kasey	Ginn
Calista	Peeples
Cassondra	Allard
Myrl	Iverson
Lauryn
Maple	Cornell
Jolene	Gage
Maximina	Mosley
Esperanza	Brandenburg
Hal	Guyton
Hyo	Battles
Lannie
Margo
Carmela	Starr
Lacie	Freedman
Danyell	Faulk
Spring	Reinhart
Hanh	Merchant
Anjelica	Stepp
Alesha	Jolly
Vonda	Beaudoin
Yuette
Caprice	Boles
Otha	Duarte
Mikki	Huskey
Kellee	Maupin
Stacee	Hooker
Luisa	Valentin
Waneta	Okeefe
Shonda	Woodall
So	Cordell
Oleta
Emeline	Chisholm
Elaina
Franchesca	Low
Devin	Shackelford
Nancie	Stillwell
Rhona	Larkin
Vernell	Sharkey
Shanna	Gaddy
Rebeca	Crawley
Nery	Ligon
Dollie	Bolt
Lien	Winchester
Yukiko	Delagarza
Gretta	Adam
Barbra
Judi
Maryalice	Dew
Ashleigh	Whittle
Hipolito	Cathey
Camelia	Guess
Shawana	Burchfield
Cecille	Bernal
Phylis	Collado
Aracelis
Regan	Land
Katerine	Cohn
Tyree	Zavala
Filiberto	Bentley
Niesha	Robson
Roxana	Humphrey
Ria	Pinkerton
Hedy	Pridgen
Otelia	Mcnutt
Johnsie	Ziegler
Phoebe	Pyle
Leisha	Higginbotham
Lakesha	Rafferty
Marna	Halstead
Gwyneth	Stuart
Yolonda	Rendon
Tatum	Callender
Elinor	Bouchard
Brittani	Craven
Evie	Soria
Elvis	Sosa
Marylouise	Humes
Chi	Mcdonnell
Genna	Shorter
Milan	Stamps
Kyra	Dellinger
Nadia	Prather
Chan
Kimberli	Clemmons
Lorretta	Nava
Janae	Cassidy
Milagro	Lundy
Minda	Ybarra
Basilia	Grisham
Raleigh
Ethan
Norah	Finney
Marlin	Good
Rozanne	Ocasio
Leslee	Osborn
Barbera
Bulah	Kelsey
Deetta	Kozlowski
Stacey	Marcotte
Samira	Brewster
Elvina	Oswald
Ardell	Ellison
Lizabeth
Cleveland	Matteson
Tamekia	Betts
Leisa	Soliz
Colby	Sikes
Gaylord	Ham
Obdulia	Ridenour
Karolyn	Dale
Meryl	Suarez
Onie	Rea
Carroll	Callaway
Collene	Holguin
Harold	Hein
Marietta	Rauch
Loan	Agnew
Broderick	Whaley
Elli	Canady
Grazyna	Rosario
Daysi	Whalen
Lucinda	Oliva
Margurite	Dubois
Pierre	Simonson
Winter	Box
Marcy	Lavigne
Lady	Aiken
Harland	Willard
Carlyn
Iliana	Menendez
Margareta	Ware
Winnifred	Solomon
Margeret	Baxter
Lanell
Katelyn	Denney
Carissa	Bauer
Numbers	Severson
Lynell	Comstock
Tenesha	Flynn
Carrol	Manson
Madelyn	Libby
Zachery	Knutson
Sybil	Pollard
Misha	Hurd
Everette	Nieves
Kathaleen	Vanburen
Oralee
Lauralee
Roy	Trout
Diedra	Rollins
Lurline	Stroud
Thuy	Laporte
Nelda	Kaiser
Vonnie	Wing
Kathrin	Bergeron
Kenda	Adamson
Derick	Crowell
Telma	Schreiber
Demetrice	Chamberlin
Sarina	Aleman
Eugene	Richard
Trey
Gerry	Dowell
Dessie	Keeney
Jenifer	Fort
Titus	Goebel
Tandy	Hager
Sandi	Stiltner
Verona	Bradbury
Dorian	Jefferies
Georgetta	Hackney
Glinda	Corbin
Eugenio	Haugen
Corrine	Fulcher
Maribeth	Masterson
Bettyann
Trisha	Mcreynolds
Kum
Tawanna	Winston
Daniele	Abney
Hulda	Wester
Saran	Maguire
Bryce	Banda
Machelle
Lorna	Villalobos
Peter	Hanna
Margrett
Marcelle	Whitmore
Marquetta	Salmon
Maybelle	Rosas
Maria	Paquette
Jung
Shaquana	Rountree
Georgette	Benitez
Yolande	Lyman
Blair	Tobias
Marcell	Jacobsen
Bette	Polanco
Sarita	Russo
Crystle	Goetz
Lasandra
Vanda	Mancini
Santina	Stull
Branden	Brackett
Felisa	Cotton
Xuan	Caskey
Ivelisse	Davila
Valeri	Lewandowski
Iraida	Michel
Christena	Sapp
Andria	Spalding
Viviana	Ramsay
Catherina	Wofford
Miss	Braxton
Shona	Lott
Myrle
Janise	Connell
Angelia	Shuman
Merrill	Lundberg
Willia	Lemieux
Daphine	Espinosa
Joie	Soriano
Lashon	Timmons
Robbin	Worthington
Kareen	Naranjo
Maye	Tovar
Gala	Moyer
Trudi
Dania	Zuniga
Alita	Hairston
Kali	Fraley
Hermina	Moniz
Lorean	Kohn
Tessie
Yasmine	Fortin
Yolando	Lea
Annalee	Galarza
Michael	Gillen
Ninfa	Labbe
Mora	Outlaw
Arica	Torrez
Nohemi	Spann
Sueann
Jacquelyne
Gus	Bourque
Velvet	Council
Kathey	Valdes
Teressa
Bianca
Donette	Clary
Catheryn	Dukes
Marcie	Hanley
Rosenda	Metzger
Silvana
Tobi	Whitfield
Cliff	Criswell
Agripina	Easter
Mozell	Hibbard
Sebrina	Pringle
Ji	Hebert
Willene	Townes
Jessi	Mccallum
Hien	Benavidez
Tobie	Baca
Dirk	Ellington
Hyon	Wilde
Debroah	Mcintyre
Cindi
Concha	Houghton
Karol	Mchenry
Edwardo	Gerber
Joaquin	Gil
Kaitlin	Smiley
Truman	Cordova
Kacie	Bethel
Brett
Malka
Larraine
Candida	Barone
Earlene	Carver
Cherish	Holcomb
Greta	Ott
Nereida	Bray
Lashanda	Flemming
Maryln	Her
Murray	Haley
Sidney	Gaston
Colette	Leake
Latia	Stephenson
Latoyia	Timm
Meri	Moffitt
Versie	Pierre
Freeman	Sander
Laurena	Manuel
Trudie	High
Mika	Xiong
Kendrick	Valenzuela
Chadwick	Asbury
Pansy	Fry
Tamica	Slater
Rosella	Randolph
Lorette	Crutcher
Raelene	Messenger
Alva	Kirkwood
Dortha	Snodgrass
Shala	Valenti
Nancee	Belton
Han	Brogan
Helena	Weis
Milford	Harwood
Tod
Juli	Cash
Dalia	Negron
Jeannetta	Badger
Jaimee	Denson
Merissa	Dallas
Chasity	Mccarty
Hollis	Lira
Vikki	Madden
Estell
Wyatt	Trask
Berry	Burnham
Kym	Samson
Bell
Nobuko
Cinda	Vandyke
Ryan	Quintanilla
Cherise	Knowlton
Dino	Tolbert
Liz	Emery
Beula	Blalock
Camila	Barr
Dawne	Askew
Kam	Curtin
Laurinda	Romano
Libbie	Martell
Arlinda	Andrade
Jewel	Saxon
Von	Royer
Timika
Ranee	Peoples
Melvina	Bostick
Migdalia	Sell
Lovetta	Pinckney
Meda	Fairbanks
Mirna	Holden
Remedios	Patino
Jacqui	Escobedo
Sherly	Valentine
Artie	Morrill
Harley
Ai	Trinidad
Micheal	Hoover
Winfred	Parent
Leta	Saxton
Domenic	Minter
Loralee	Salisbury
Shaun	Aldrich
Lily	Purnell
Arnoldo	David
Cherrie	Sierra
Larue	Crews
Marla	Snowden
Twanna	Sommers
Tonia	Humphreys
Angelita
Janean	Stout
Jamika	Goldstein
Karri	Foley
Blair	Tanaka
Laurence	Cecil
Amee	Jobe
Pamella	Do
Vilma	Trudeau
Kina	Blackwood
Julieann	Downey
Kayleen	Lovelace
Luis	Pauley
Nana	Robb
Leonore
Rosalind	Chapin
Christen	Echevarria
Huey	Presley
Issac	Banuelos
Carletta	Mojica
Jacqulyn	Arreola
Barney	Harlow
Evelina	Sargent
Mertie
Lynnette	Orellana
Daria	Pitts
Jeneva	Seay
Criselda	Bozeman
Toshiko	Castleberry
My
Rubi
Kaylene	Macias
Santana	Lang
Codi	Randle
Annice	Tamayo
Son	Rowland
Josefa	Clawson
Eufemia
Aja	Norfleet
Kayleigh
Soila	Fogle
Goldie	Culbertson
Terrell	Clemens
Manda	Simons
Haywood	Van
Missy	Arce
Zola	Greenlee
Jong	Pogue
Lakisha
Glenn	Mcgowan
Carita	Kimball
Vasiliki	Keith
Len
Shayla	Batts
Naida	Villegas
Cristen	Boren
Kathyrn	Vick
Francisco	Gandy
Oneida	Clevenger
Kraig
Marilou	Stine
Bree	Song
Kendal	Yarbrough
Gabriela	Salinas
Florrie	Paine
Earleen
Sabina	Reardon
Lou	Tisdale
Sanda	Barrios
Joline	Steen
Sabine	Elias
Ossie	Mccue
Kennith	Stoll
Clair	Sparrow
Arie	Fite
Mica	Dexter
Veronique	Blevins
Ward	Brill
Kenisha	Roderick
Malorie	Qualls
Monnie
Myrna	Byrne
Francene	Messer
Abe	Cline
Tomoko	Mcclellan
Inger	Mullin
Nathanial	Kang
Adele	Call
Jamey	Ralph
Malisa	Bullard
Donnell	Hoppe
Genaro	Welker
Marcela	Gunther
Jazmin	Seitz
Rosamaria	Tibbs
Velia	Kowalski
Starr	Bland
Dann	Starling
Lorrie	Nagle
Carley	Aiello
Consuelo	Wentworth
Kecia	Putman
Kanisha
Tamela	Lumpkin
Mayola	Deal
Adela	Breaux
Martin
Florene	Collazo
Beverley	Turpin
Twana	Morrissey
Brunilda	Lively
Lin
Conception	Toler
Elba	Cordero
Teresia	Barnhill
Madelaine	Benedict
Zachariah
Erline	Muse
Reggie	Courtney
Salome	Batson
Shantay	Skidmore
Laine	Engle
Cordell	Tuggle
Eneida	Dodge
Christinia	Petit
Gisele	Wray
Athena	Folsom
Lyndsay	Domingo
Maranda
Kasandra	Ricketts
William	Hargrove
Giuseppe	Mead
Thresa	Best
Leighann	Palma
Jammie	Vanhorn
Reyna	Mcgehee
Quincy	Conrad
Cindie	Doty
Terrie	Blue
Kemberly	Sellers
Sherice	Dougherty
Ok	Treadway
Errol	Root
Tristan	Werner
Kirby	Brownlee
Jerri
Alishia	Espinal
Bobbie	Ruffin
Chanell	Mattos
Marisha	Dominguez
Reginia	Arellano
Viki	Vidal
Joette	Forrest
Ashanti	Cullen
Katharine	Wendt
Edris	Connors
Luci	Arthur
Mechelle	Fullerton
Stefanie	Cornwell
Gale	Gough
Jonnie	Oliveira
Curtis	Upshaw
Sydney	Matos
Shaunda
Leif	Blunt
Jeanine	Sandlin
Myong	Blaylock
Angelo	Roland
Ivory	Beam
Amado	Fitts
Florentina	Hatley
Yessenia
Candelaria	Gillis
Rusty	Mcclanahan
Dannie	Griggs
Sommer	Maxey
Rolanda	Haller
Jordon	Lai
Veola	Brand
Jalisa	Alarcon
Britt	Oglesby
Leanora	Leggett
Mirella	Passmore
Maegan	Mccracken
Brandie	Hartwell
Sung	Wesley
Jacquelynn	Dawkins
Debby	Keaton
Sparkle	Mercer
Jeffry
Melania	Sorensen
Donnie	Rash
Yoshie	Britt
Kirstie
Kami	Keen
Mari	Carranza
Laurette	Braswell
Bertram	New
Sheron	Gates
Dinorah	Mabe
Marceline	Connolly
Raymonde	Colwell
Shandi	Wadsworth
Carmelo	Noe
Gaynell	Pinson
Lyndon	Turley
Keesha	Gamez
Carlie	Kuntz
Jacquiline	Mcwhorter
Luba	Allan
Casimira	Foust
Julissa	Wahl
Carie	Parr
Verdell	Singh
Blondell	Grubbs
Alana	Marks
Lashaunda	Fennell
Cassie
Isabella	Thornhill
Aretha	Irish
Clotilde
Fatima
Marx	Carrasco
Karey	Covington
Darline	Leung
Sharri	Butcher
Rosetta	Shaffer
Werner	Dube
Jeanna	Everhart
Coreen	Avila
Asuncion	Bachman
Hye	Woodruff
Hermelinda	Gee
Judie	Chamberlain
Teodoro	Haney
Norman	Vail
Gaye	Fallon
Gussie	Brandt
Collette	Beasley
Wendi
Kit	Mcgregor
Jacquetta	Elder
Williams	Burdick
Lincoln	Bolden
Meta	Boland
Mckenzie	Ratcliff
Sherrie	Luke
Evalyn	Boucher
Monserrate	Logue
Bethann	Thigpen
Kathe	Crook
Freddy	Guevara
Marylyn	Lyles
Lakenya	Loper
Jessika	Choate
Catarina	Orosco
Layne	Carmichael
Yen	Dancy
Kellye	Dowd
Kelsi	Henke
Francisca	Dill
Leanna	Hindman
Sang	Conn
Elane	Nowlin
Letisha	Lemke
Roslyn	Durham
Shandra	Ladd
Daryl	Finch
Risa	Thurman
Benita	Hadden
Floy	Bittner
Jon	Broussard
Tiesha
Dylan	Jeter
Taunya	Greenfield
Edythe	Arteaga
Vivien	Anglin
Cherri	Sturm
Emmie
Chauncey	Barbour
Kandy	Darnell
Robby	Bullock
Bobbi	Lamar
Booker
Era	Spellman
Nicki	Holbrook
Ashly	Boehm
Dallas	Thacker
Cheyenne	Caraballo
Arlyne	Stubblefield
Un	Caudill
Nieves	Bivens
Magaly	Wyatt
Tomeka	Marlowe
Dina	Meier
Donnetta	Pacheco
Rueben	Lavender
Fe	Cabrera
Kyla
Nisha	Draper
Ranae	Caswell
Jaleesa	Kilgore
Nelle	Havens
Pearly	Cason
Andra	Dell
Leonor	Regalado
Buck	Whitmire
Sharell	Bayer
Sharyl	Hannon
Annika	Cary
Epifania	Wiley
James	Armstead
Gertude	Huerta
Starla	Roe
Babette
Merna	Nicholson
Chun	Gurley
Tania	Pickett
Marlena	Rosen
Ermelinda	Krieger
Angeline	Murdock
Elisha	Amato
Roberto	Geary
Quinn	Holliday
Raisa	Mccray
Virgil	Worrell
Gearldine	Leslie
Georgine	Winter
Olin
Elanor
Marybelle	Mcdougal
Cathryn	Wayne
Shanika	Gallardo
Jeane	Latimer
Denver	Mcfarlane
Albertine	Toledo
Anisha	Gann
Rodrick
Shawnta	Avery
Chanda	Billiot
Jaqueline
Liana	Deluca
Vesta	Snell
Venetta	Nielsen
Suzie	Cheng
Yael	Venable
Donella	Higdon
Juliette	Prado
Arianne	Ash
Sharda
Alfredia	Kaye
Cleotilde	Fine
Ashley	Bartley
Chong	Israel
Isidra	Saucedo
Eustolia	Pantoja
Virgilio	Braden
Jeramy
Celestina	Chong
Jesica	Staggs
Ricki	Huntley
Maurine	Woodard
Kimberlie	Betz
Serina	Walls
Jennine	Noland
Floretta	Lowell
Hilde	Ledford
Caroyln	Correa
Charissa
Gino	Turney
Marcelo	Hilton
Jae	Olivo
Clement	Wilt
Larisa	Browder
Tesha	Marvin
Michale	Fleck
Zelma	Albers
Reuben	Cotter
Zora	Bills
Winford	Fritz
Gregoria	Niles
Tashia	Campos
Robbi	Brenner
Elina	Pack
Patricia	Bronson
Charleen	Mangum
Tressie	Judge
Gerry	Hardman
Akiko	Mauldin
Sal	Toliver
Aurore	Gilson
Julieta	Pollack
Reinaldo	Bratton
Leeann	Embry
Elida	Rooney
Paulina	Brantley
Mauro	Keating
Britney	Healey
Penney
Maryam	Colburn
Deja	Chestnut
Toi	Martel
Christoper	Bernard
Drew	Peak
Michel	Beal
Ivana	Boudreau
Sofia	Chadwick
Nga	Merriman
Patria	Schmitz
Dreama	Ripley
Larae	Martino
Valda	Romeo
Cory	Landis
Ambrose	Vickery
Frida	Kraft
Dusty	Fajardo
Deidra	Parris
Val	Hostetler
Randi
Jude	Tharp
Fredricka	Shirley
Barton	Christy
Jamila	Buckingham
Joesph	Howland
Precious	Greiner
Sade	Sprague
Krysten	Huggins
Rubin	England
Mayra	August
Stephnie
Refugio	Montero
Lael	Sears
Glory	Carrillo
Ellan
Dusty	Hennessey
Mose	Lovell
Viva	Gold
Parthenia	Waite
Joelle	Hurst
Rod	Aguilera
Charita	Oliphant
Eartha	Chism
Markita	Spear
Thea	Bethea
Clarissa	Maclean
Shawn	Barrows
Bao	Dubose
Joannie	Hassell
Luann	Plunkett
Tresa	Skinner
Frances	Pulliam
Latanya	Mears
Ira	Kirkpatrick
Stevie	Sherrod
Tanika	Barnard
Marlin	Isaacs
Maryjane	Downs
Karisa
Mirtha	Hamel
Vinnie	Tong
Lory	Belanger
Ardelia	Vickers
Lahoma
Liza	Ives
Kamala	Alfaro
Lisabeth	Mcneal
Lamont	Blum
Shantel	Camp
Kandi	Stackhouse
Lindsy	Kessler
Delmar	Kuykendall
Jeromy	Bussey
Alfonzo	Cardenas
Avril	Connor
Emery	Sousa
Adrien	Berg
Roxane	Doan
Margery	Alves
Cher	Stoddard
Kyong	Greco
Li	Gary
Matilde	Donohue
Alona	Tenney
Latina	Yost
Isobel	Merrick
Alyse	Conley
Kyung
Gertha	Bader
Marylynn	Jasper
Agueda	Langford
Tristan	Landrum
Rocky	Marrero
Collen	Wimberly
Shauna	Kraus
Shonna	Farr
Eddie	Chastain
Kylie	Coulter
Claretha	Roller
Cathrine	Gracia
Trena	Hoff
Savannah	Sexton
Jerold	Speed
Marline	Mcginnis
Pamila	Montoya
Rosalia	North
Fanny	Rowan
Willian	Bobbitt
Dorethea	Horner
Treva	Uribe
Renda	Rutherford
Stacy	Autry
Judson	Mejia
Sasha	Grantham
Shalon	Leighton
Karine
Gaston	Spain
Isidro	Schuler
Masako	Vest
Miquel	Echols
Charisse	Mckenna
Inga	Tremblay
Celinda
Candi	Barela
Ludivina	Thornburg
Ma	Wyman
Sallie	Fuqua
Darwin	Mayer
Jaymie	Scarborough
Tamra	Seiler
Cleo	Jay
Edison	Counts
Palmira	Faber
Denice	Koehler
Charise	Swafford
Rolland	Tejeda
Dorathy	Paradis
Joe	Franco
Rowena	Engel
Pa	Roush
Aura	Hynes
Dovie	Linkous
Leatrice	Hopson
Debrah
Johnie	Wenger
Darby
Lawana	Sharpe
Jayna	Chu
Britany	Epstein
Lashawnda	Delvalle
Shavonne	Cheung
Mallory	Pulley
Anya	Lindgren
Kendall	Casillas
Lynna	Mintz
Alisha	Stamm
Kirsten	Ivory
Rey	Stein
Temple
Darci
Loyd	Maher
Dannielle	Mares
Nam	Barron
Millie	Stallings
Serita	Dietrich
Ute
Dulcie	Shelley
Shannan	Gannon
Raven	Squires
Carmelia	Woodcock
Loria	Odonnell
Anabel	Villarreal
Corine	Quick
Fawn	Caruso
Walton	Fries
Assunta	Horsley
Lyndia	Cleary
Keturah	Bliss
Eleonora
Trina	Swank
Felton	Free
Sharie	Brandon
Britt	Hillman
Tynisha	Gorham
Angle	Woo
Debbi	Grooms
Deneen	Urbina
Jarrett	Ashford
Shalonda	Manzo
Michal	Boyce
Jin	Hoyt
Takako
Carolina
Christi	Corbitt
Avery	Freund
Gayla	Slone
Keeley
Mei
Ching	Schuster
Gennie	Shanks
Oralia	Nunley
Henry	Dyer
Jinny	Duckett
Kristel	Bayne
Fidelia	Marquez
Mitch	Houser
Deedee	Landry
Shawnna	Seeley
Tyler	Peterman
Lorri
Refugio
Dan	Velazquez
Lissette	Binkley
Dorene	Irvine
Kimber	Witte
Shaniqua	Tilley
Selma	Canty
Quentin
Numbers
Season	Freed
Jeniffer	Mattison
Inge	Garnett
Deangelo	Langston
Detra	Shephard
Senaida
Cami	Turk
Arcelia	Beauregard
Jonas
Hortensia	Meacham
Marylin	Sprouse
Krystyna	Minton
Santo	Crockett
Shira	Guffey
Carri	Mcculloch
Agustin	Whited
Jerilyn	Marcus
Yoko	Jaeger
Maragaret	Cousins
Alycia	Beers
Helga	Kay
Linette	Teeter
Soledad	Knott
Vallie	Amador
Claribel
Christian
Madelene
Jerrie	Epps
Jude	Mcadams
Man	Frias
Arianna	Cameron
Arletha	Mccreary
Cherry	Demarco
Wan	Isaac
Thersa	Slade
Karren	Card
Shawanda	Eason
Arlena	Bustos
Thao	Isbell
Raymond	Maes
Aldo
Chantal	Leclair
Maia	Mahon
Bella	Raymond
Faustina	Dickens
Pearlie
Chu	Corral
Rivka
Wilhemina	Hollis
Emmaline	Carswell
Adelaide	Frey
Brittanie	Stringer
Cecile	Weatherly
Delorse	Holm
Louie	Gaither
Candance	Atwood
Daniela	Posey
Kenneth	Layman
Agustina	Albright
Daniel	Meade
Milissa	Roldan
Arron	Cupp
Malena	Hanlon
Verdie	Mcmahon
Zula
Eugena	Tapp
Maragret
Faviola	Fraser
Brenton
Marvis	Boisvert
Noreen	Womack
Juliet	Jack
Fidel	Blocker
Lashunda	Muniz
Ettie	Cates
Harriett	Liles
Margarete	Janes
Marshall	Portillo
Glynis	Farris
Cara	Blackmon
Araceli	Kolb
Gale	Paulsen
Hyun	Mccauley
Elliot	Mcfadden
Lore	Curley
Cornell	Mackenzie
Clora
Lorine	Seibert
Roseann	Schulte
Monroe	Shea
Tari	Reis
Lashandra	Spooner
Charlena	Cuevas
Tomiko	Lacey
Rufina	Antoine
Bronwyn	Kiser
Madge	Barfield
Yvone	Serna
Florentino	Lind
Erlinda	Siegel
Fausto	Kinder
Lakia	Whiteside
Ginny
Lilliana	Wallis
Russel	Guillory
Adria	Guillen
Alexander	Musgrove
Cammie	Vann
Shin
Jonell	Knowles
Laree
Rich	Daugherty
Zita	Boudreaux
Joaquina	Hogg
Sook	Bearden
Georgeann
Stacie
Ivory	Harness
Irena	Peltier
Lorelei	Galloway
Kaley	Harbin
Una	Berman
Jamal	Paris
Sachiko
Laverne	Tan
Melda	Tice
Claudine	Frost
Salena	Hawes
Alix
Ellamae	Winstead
Katharina	Elkins
Shay	Martins
China	Herndon
Ericka	Meza
Nathalie	Mccarter
Raina	Keeler
Kandice	Proctor
Dee	Colley
Reiko	Stoner
Hillary	Churchill
Isabell
Khalilah	Mosby
Alla	Forney
Yuriko	Trotter
Lucilla	Prentice
Edgardo	Garland
Isaura	Guidry
Angelic	Varney
Claris	Dorsey
Dulce	Mcmullen
Marina	Hogue
Becki	Aldridge
Haley	Godfrey
Ruthe	Horne
Eleanora	Bolton
Ashli	Lemay
Dede	Florence
Delora
Chasidy	Read
Marybeth	Wentz
Cleora	Abraham
Ariana	Bacon
Lindy	Malley
Maire	Snow
Freida
Anderson	Bender
Karmen	Billingsley
Seymour	Redmon
Karissa	Lear
Signe
Brian	Reno
Sang	Keene
Jeanene	Doll
Verda	Brothers
Kallie	Fain
Shondra	Huey
Guillermina	Duke
Sandee	Holly
Adriana	Gooch
Lucio	South
Yuk	Sumpter
Clarice	Wilder
Cinderella	Venegas
Galen	Kasper
Marissa	Graff
Adalberto	Sturgeon
Soon	Chavis
Trudy	Minor
Nedra	Villa
Tamala	Luckett
Ina	Durand
Josphine	Voss
Tabatha	Ibarra
Madalyn	Everett
Clemencia	Brunson
Katelynn	Nance
Sherwood	Clancy
Lauren	Ely
Leatha	Staton
Patrina	Janssen
Hisako	Desantis
Zana	Mahoney
Helene	Sherwood
Cassaundra	Medlock
Armand	Delaney
Clarita	Coyle
Robbyn	Blackman
Louella	Bowser
Bailey	Rutledge
Drema	Dudley
Dominique	Bowie
Hilton	Sauer
Emiko	Dozier
Desire	Terrell
Laila	Singletary
Chae	Lund
Elenore	Malcolm
Elene	Kerr
Hoa	Hodge
Lavinia	Shockley
Nicolette	Millard
German
Tiara
Brinda	Vanover
Olympia	Hoyle
Cruz
Esmeralda
Shirlene	Pomeroy
Catina	Joiner
Jona	Sheppard
Trish	Whelan
Arlie
Thi	Getz
Damian	Couture
Eladia	Lunsford
Aleshia	Shipp
Antonietta	Velasquez
Kyle	Cronin
Minna	Case
Ja	Hatchett
Michell	Dang
Jadwiga	Wisniewski
Ivey	Akin
Damien	Cardwell
Stefani	Gist
Karyn	Frederick
Delicia	Platt
Bambi
Shayna	Dickey
Tamika	Hardwick
America	Stafford
Jutta	Richie
Annamaria	Ferraro
Alethia
Adella
Caryn	Hutcherson
Callie	Steel
Evonne	Breen
Ashlie	Finley
Reanna	Aponte
Jacinta	Middleton
Ignacia	Beckwith
Rolande	Scruggs
Rachele	Livingston
Leana	Yang
King
Nelida	Doss
Adrian	Ricci
Shery	Monson
Reynaldo	Bolen
Dorothea	Hermann
Cierra	Arredondo
Jessenia	Laughlin
Bea	Callahan
Margit	Fuchs
Brain	Goss
Rutha	Keeling
Venessa	Ritter
Neda	Sotelo
Sharonda	Wheaton
Fletcher	Mcintire
Katelin	Willoughby
Mariel	Munson
Fredericka	Romo
Su	Maddox
Sanjuanita	Barbee
Kimi
Kiara	Guajardo
Danelle
Danette	Mathias
Tosha	Dunlap
Lu	Boggs
Berry	Cahill
Myles	Medlin
Claude
Bobby	Dotson
Erlene	Arroyo
Mariana	Granados
Leonie	Briones
Clare	Markley
Suzann	Littleton
Shenika	Westmoreland
Carlota	Lehmann
Lajuana
Chastity	Solano
Ronny	Farley
Martina	Broughton
Jewell	Elston
Lottie	Lafleur
Wendolyn	Gibbons
Fredric	Nelms
Janetta	Utley
Jovita
Kelsie	Peck
Salina	Flood
France	Viera
Fonda
Jayme	Beatty
Francine
Morton	Ashmore
Dion	Tribble
Cassey	Friend
Lupe	Amos
Jaquelyn
Jewell	Mcclain
Dorine	Peyton
Claudio	Fryer
Ivy	Murrell
Yong	Priest
Krystin	Hazel
Ngan	Darling
Tianna
Lorilee	Landers
Nichelle
Tierra	Castellano
Emelia	Olivarez
Thad	Woodbury
Leonardo	Whitehead
Enola	Brito
Holli	Blank
Marjory	Diehl
Anette	Schwab
Buddy	Casper
Paulita	Guerin
Sibyl	Neuman
Mariela	Mays
Deandrea	Tillery
Rudolf	Lopes
Rudy	Sides
Faustino	Marlow
Hunter	Newell
Edyth	Mahaffey
Ofelia	Whitt
Jeanelle	Cota
Janay	Bolduc
Ellsworth	Mcclure
Shonta	Steffen
Dagmar
Nanette	Pride
Vincenza	Mccain
Maud	Corey
Bryon	Short
Rosaline	Ochoa
Romelia	Batiste
Aurora	Hinojosa
Candyce	Bonner
Sabra	Arriaga
Christia	Ricks
Julene	Hildebrand
Kaylee	Donaldson
Neoma	Rudolph
Zetta	Church
Roselia	Lima
Lanette
Leandro	Castle
Lyda	Waugh
Benedict
Stacia	Lindberg
Rosanna	Driver
Alfreda	Worden
Giuseppina	Hood
Sebastian	Chisolm
Yuonne	Sells
Mollie	Keegan
Gidget	Kidwell
Lilian	Saavedra
Alysia	Hite
Ali	Escamilla
Shanda	Loftin
Fredia	Houle
Daina	Rider
Sammy	Mabry
Elissa	Mcgrath
Colene	Schmitt
Charla	Mccallister
Teodora	Starks
Karon	Seward
Demarcus	Sawyers
Ying	Hundley
Meaghan	Bisson
Dian	Bankston
Crissy	Mcduffie
Louie	Donahue
Carrol	Oleary
Lakiesha	Rayford
Treena	Hagan
Trang	Monahan
Thomasine	Barbosa
Geri	Whipple
Hong	Clifton
Hellen	Baird
Eli
Adelle	Pickering
Dale	Applegate
Setsuko	Ferrari
Tracey	Creech
Rosia	Redmond
Marlyn	Pennington
Ema
Daniell	Tejada
Tandra	Creel
Ashlyn	Sweet
Alyson	Bounds
Joleen	Gentile
Siu	Quinonez
Haydee	Furman
Brady	Vance
Maryrose	Dahl
Rayford	Burney
Nolan	Kendrick
Margert	Benjamin
Travis	Padgett
Vernita	Bright
Janella	Tompkins
Pura	Knudson
Lupe	Jewett
Estela	Fink
Tisa	Delacruz
Yuri	Gunter
Neida	Enriquez
Darlena
Shanita	Crayton
Kimberley
Bethel	Small
Leanne
Exie	Russ
Jani	Bonds
Debera	Groce
Denis	Tijerina
Ruthie	Hamm
Catrina	Hastings
Alecia	Hutchens
Laticia	Felton
Laveta	Evers
Fatimah	Fontaine
Mike	Weir
Rasheeda	Victor
Virgen	Dickinson
Almeta	Baumann
Reta	Irwin
Lyman	Chatman
Farrah	Bobo
Zulma
Fermin	Fountain
Vernon
Jackson	Yu
Venita	Wertz
Retha	Bertrand
Ginette	Borden
Darell	Winslow
Leann	Fortune
Ebonie	London
Lizzie	Milner
Barabara	Bartholomew
Lilia	Lugo
Diego	Lindstrom
Syreeta	Thorne
Jillian
Jerlene	Burk
Glennis	Darden
Cayla	Zhang
Lanny	Boyer
Lenny	Trimble
Angella
Corliss	Hand
Janett	Irvin
Mitzi	Hawley
Olene	Richmond
Consuela	Coyne
Amalia	Hutton
Tawny	Torrence
Albertha	Goode
Clorinda	Gay
Harmony	Foreman
Elenora
Nidia	Fong
Markus	Sisson
Rayna	Durden
Jimmie	Coker
Delinda	Diamond
Drucilla	Ryder
Kacy	Burnett
Felicidad	Macdonald
Charmaine
Lisbeth	Devore
Vernetta	Cortes
Ezra	Muir
Kala
Sharice	Mata
Sari	Crittenden
Jarvis	Damico
Petrina
Milagros	Roche
Luigi	Gooden
Bret	Toney
Tam	Treadwell
Lettie	Stack
Rachelle
Emmitt	Bach
Mallie	Olds
Glenna	Cardona
Eliza	Monroe
Chara	Ferrara
Billye	Finn
Janyce	Rayburn
Susann	Taber
Zoraida	Rush
Jerica	Michaels
Charline	Abell
Beryl	Scully
Abram	Yount
Eda	Ogle
Jonna	Pugh
Corrin	Edmond
Carlos	Cano
Jetta	Trujillo
Allen	Behrens
Lacy	Moffett
Kori	Wick
Karly	Chaffin
Trinity	Edmonds
Royce	Humphries
Jacques	Bruno
Corinne	Hoskins
Filomena	Funderburk
Denny
Irish	Villareal
Sherryl	Hurley
Apryl	Grissom
Maya	Roach
Jami	Locklear
Donita	Thomason
Evangelina	Angulo
Lasonya	Mchugh
Tawanda	Stanfield
Phuong	Kincaid
Petronila	Roby
Alexa	Pease
Janel	Sisco
Allena	Leon
Nikia	Toro
Lala	Nagel
Malinda	Rawls
Darron	Burr
Taneka
Philomena	Alicea
Sima	Guy
Edda	Maples
Dario	Abernathy
Perry	Stallworth
Beata	Jeffries
Dorinda	Choi
Eulalia
Omega
Rocio	Sizemore
Nella
Louis	Coronado
Rana	Smalley
Erasmo	Ali
Margarette	Kauffman
Ouida	Shively
Ricarda
Illa
Veronika	Rudd
Lizeth	Ritchey
Talisha	Bostic
Nona	Singer
Aleisha	Mcvey
Shelba	Aaron
Marcelene	Hong
Jarred	Blount
Tajuana	Mast
Delaine
Denisse	Morley
Johnson	Bales
Christin	Fontenot
Olimpia	Denton
Antwan	Lafferty
Tennie
Bettie	Brink
Emerald	Larsen
Sonny	Bratcher
Rheba
Blanch
Malvina	Farias
Charlott	Ashe
Leda	Larue
Odessa	Mcdermott
Cary	Cantrell
Thanh
Deena	Fischer
Annelle	Creighton
Gianna	Moon
Kenia
Joni	Stpierre
Yetta
Ladawn	Mcfall
Lavon	Mccollum
Tereasa	Mattox
Shelby	Bond
Mason	Cornish
Heike	Arsenault
Jenine	Mulligan
Shon	Ivy
Stanford
Dyan	Tierney
Flavia	Suggs
Tammi	Calderon
Deandre	Pike
Fermina	Mccrary
Renato	Olsen
Delena	Poulin
Theodora	Wang
Waldo
Queen	Hefner
Hertha	Malloy
Lacresha	Cottrell
Lizzette	Wilburn
Nenita	Cantu
Despina	Carder
Alica	Ackerman
Adrianna	Laster
Clementina	Sayre
Breanne	Rhoads
Christel	Teel
Tiffani	Stark
Regena
Armanda	Majors
Nichol
Roselee	Harder
Jose
Eric	Slaton
Doloris
Mindi
Mitchell	Bunker
Cristobal	Burgos
Remona	Dehart
Mao	Hedrick
Merlin	Tang
Tyisha	Hannah
Theresia	Helton
Loyce	Carrion
Latonia	Shipman
Gwyn	Belt
Kimiko	Zepeda
Xiomara	Lerner
Aracely	Bledsoe
Cyril	John
Lawrence
Gabriel	Pinto
Virgina	Easton
Pilar	Totten
Elmo	Guerra
Camilla	Hulsey
Keena	Sowers
Stevie	Springer
Bong	Goodrich
Josette	Samples
Lezlie	Guest
Cherilyn	Heckman
Nickolas	Akins
Arthur
Marty	Waterman
Shanae	Ezell
Danna	Lash
Willena	Lusk
Gladis	Sun
Korey	Bolin
Ernestina	Han
Janeth	Babcock
Moshe	Christianson
Sunday	Begay
Alvaro	Mcafee
Caitlin	Hagen
Landon	Picard
Berniece	Pape
Brigida	Robles
Lenna	Vo
Majorie	Machado
Lean	Steward
Teddy	Colson
Lou	Aguiar
Daisey	Bingham
Buford	Thatcher
Michaele	Roney
Gilda	Delossantos
Lourdes	Gossett
Reina	Whatley
Hyacinth
Ilona	Cormier
Morgan	Lemus
Jonelle	Lavoie
Annmarie	Obryan
Annalisa	Seifert
Delphine	Canales
Paola	Clegg
Nannette	Harlan
Malissa	Bynum
Rima	Causey
Gavin	Stauffer
Corey	Overby
Chiquita	Feeney
Emelda	Hargis
Domonique	Travers
Marcene
Valarie	Allred
Tuan	Goble
Elda	Ridley
Dorthea	Tavares
Cyndi
Gisela	Delarosa
Oma	Matney
Caren	Locke
Lang	Linder
Ulysses	Mcnally
Logan	Irving
Yong	Honeycutt
Sherril	Giordano
Casie	Fay
Hedwig
Matilda	Stahl
Tiera	Longo
Benton	Plante
Moriah	Hartman
Antone	Corley
Eilene	Folse
Le	Hinkle
Micki	Zamora
Birgit	Dugan
Gigi	Bruton
Bryanna	Buffington
Tilda	Poston
Keren	Coffey
Tena	Jacques
Deeann	Burrow
Mammie	Rinaldi
Selina	Henning
Stephan	Ness
Mavis	Nadeau
Pearlene	Casas
Velda	Wolf
Nadene	Gilliam
Sau	Turnbull
Jefferson	Dayton
Selene	Yoder
Scarlet	Grey
Almeda	Condon
Perla	Gore
Shakia	Pettigrew
Eldon	Tellez
Tiffiny	Mckeown
Florinda	Parrish
Nola	Bermudez
Terica	Whittington
Jacalyn	Fenton
Stefany	Clemons
Reita	Eubanks
Taryn	Kimbrell
Kimberely	Hiatt
Royce	Vernon
Joella	Baylor
Ronnie	Reagan
Marinda	Rankin
Marci	Pruitt
Mathilde	Heredia
Shaunte	Madrid
Phyliss	Comer
Charles	Marx
Brande	Haggard
Jayne
Luise	Moreland
Enda	Sorrell
Letitia	Abrams
Jodie	Arevalo
Anastasia	Cochran
Coleen	Covey
Altha
Dillon
Bonny	Bautista
Quinn
Rochell	Dorn
Jolie	Sheldon
Lina	Main
Gay	Tomlinson
Alisa	Wilkes
Madaline	Cheney
Bettye	Kunz
Margart	Mount
Bernadine	Horn
John	Kimbrough
Dennis	Headley
Theressa	Noyes
Hortense	Homan
Mercedez	Wynne
Dewitt	Connelly
Alline	Covert
Yasuko	Tapia
Tifany	Galvez
Frieda	Alonzo
Nida	Oconnell
Janeen	Fultz
Coralee	Trapp
Ludie	Bello
Carmina	Dwyer
Edra	Waddell
Corie	Schindler
Loraine
Breana	Meeks
Dorsey
Isaiah	Oaks
Angeles	Esquivel
Kiana
Shawnee	Mcnabb
Robbie	Elam
Alec	Dupuis
Carlee	Ontiveros
Lavelle	Gomes
Berna	Giron
Florencia	Borges
Anika
Armida	Hawk
Slyvia	Lemons
Eugenia	Bickford
Donnette	Carlton
Delcie	Spinks
Carina	Brannon
Dorie	Vallejo
Ferdinand	Witt
Vada	Binder
Marcel	Robins
Hue	Sauls
Mana	Mcewen
Luella	Kunkel
Rosalinda
Elvera	Lord
Deb	Huang
Gita	Ambrose
Sage
Tarah	Benton
Rebbecca	Cote
Patrick
Tamera	Headrick
Coleman
Armandina	Shannon
Tamie	Sepulveda
Audrie	Odell
Cleo	Clement
Pearline	Lin
Marvella	Burger
Tana	Dyson
Carin
Anastacia	Slaughter
Katrice
Marleen	Metz
Ruthanne
Gertrudis	Champion
Nakia	Hyman
Georgann	Somers
Ardith	Dutton
Carisa	Cosby
Leonia	Maier
Tressa	Muhammad
Lakeesha	Lujan
Joslyn	Chan
Charley	Hickey
Elfrieda	Blythe
Davina	Wiseman
Kera	Irizarry
Awilda	Cerda
Justa	Kenyon
Annett	Tipton
Shayne	Mullis
Ozella	Huston
Fallon	Sager
Tula	Mckay
Candie	Shull
Connie	Vitale
Concepcion	Perrin
Irina	Khan
Cordia	Sallee
Angelyn	Haskell
Rebbeca	Christiansen
Charlyn	Drayton
Maricruz	Rau
Waltraud	Smyth
Melany	Gilchrist
Graig
Kristofer	Kimble
Jeanett	Rangel
Carmel	Jernigan
Nakesha	Purvis
Ligia	Bedford
Mignon	Farrell
Leia
Chia	Coughlin
Babara	Pina
Hershel	Sipes
Karlyn	Carlin
Lakita
Loreta	Pineda
Micah	Birch
Julienne	Walston
Romana	Hauser
Deloras
Wynona	Linares
Aisha	Mobley
Dong	Ruby
Keneth	Sammons
Monet	Goff
Zandra	Workman
Shera	Law
Ferne	Lemmon
Cassy	Smithson
Vertie	Reich
Creola	Klinger
Raye	Perdue
Colton	Dewitt
Valentin	Rizzo
Dominique	Culpepper
Vickey	Phipps
Deadra	Conyers
Jerrell
Loris	Talbert
Ewa	Boling
Melina
Irmgard
Sharlene	Beattie
Shad	Keefe
Renita	Packard
Laurice	Macklin
Roma
Idell	Ellsworth
Michal	Saenz
Twanda
Lorinda	Ebert
Robbie	Clanton
Johanne	Seals
Laurine	Capps
Jannie	Latham
Valentine	Mcswain
Tuyet	Bauman
Shavon	Leahy
Rafaela	Pedersen
Kena	Paxton
Margy	Mckeever
Jenee	Oden
Sherill	Jameson
Mariette	Akers
Mark	Busby
Celena	Doe
Lachelle	Mixon
Camellia
Sana	Ha
Bo	Espinoza
Torri	Crespo
Tawnya
Jame	Linn
Garnet	Fuentes
Thomasina	Cornelius
Sung	Bravo
Corazon	Runyan
Melodee	Cope
Kimbra	Beard
Renay	Whitman
Heath	Mcmaster
Xochitl	Dove
Chas	Laws
Lenora	Yoo
Marilu	Arndt
Ceola	Abreu
Dakota	Koonce
Glayds	Nettles
Nyla	Pressley
Freeda	Loera
Hiram	Chang
Minh	Pederson
Jamee	Keener
Raguel	Towns
Marylee	Temple
Dionna	Gladden
Augustina	Dickerson
Rona
Cassi	Ocampo
Natashia
Annita	Pryor
Alden	Avalos
Ardella	Shearer
Demetrius	Zook
Tai	Lara
Marni	Waldron
Mozelle	Hornsby
Mee	Crouch
Elise	Pounds
Arvilla	Anthony
Ayesha	Musser
Cecil	Gillette
Genoveva
Melva	Zarate
Deonna	Dillon
Oda
Sharee	Gonsalves
Vernie	Burnette
Towanda	Tuck
Luana	Duggan
Sharita	Calloway
Morgan	Schwarz
Dacia
Karyl	Cowles
Carly	Hardesty
Reda	Adair
Myung	Reinhardt
Leon
Mickey	Catron
Deana	Cheatham
Lelia	Welsh
Vannessa	Lackey
Katia	Vera
Theron	Ammons
Dinah	Harding
Dona	Schulze
Ha	Boykin
Margarett	Hailey
Sherlyn	Raynor
Joi	Strange
Bruno	Sanford
Sheridan
Donetta	Granger
Golda	Schiller
Lamonica	Stover
Jacinda	Dalton
Rashida	Apodaca
Arielle	Holley
Deidre	Gant
Hui	Ayers
Cristine	Wilbanks
Jeffie	Lefebvre
Maira	Chapa
Eleni
Kelsey
Bud	Stephen
Reed	Denham
Marget	Pendergrass
Brittny	Overton
Tiffanie	Bunn
September	Eddy
Brandee	Gable
Jodee	Dolan
Cari	Spradlin
Corrie
Sherron	Byrnes
Lita	Kidd
Sol	Perales
Myriam	Trammell
Augusta
Kittie	Herron
Tony	House
Shizue	Yanez
Elliott	Mallory
Ozie	Faulkner
Wonda	Robert
Alexandria	Dick
Isela	Chow
Janelle	Bollinger
Whitley
Josiah	Mackie
Omer	Anaya
Ola	Salerno
Angelena	Concepcion
Tammie	Grigsby
Vicente	Bolling
Leontine
Charlie	Mccann
Andree	Finnegan
Kira	Joyner
Cathi	Aguirre
Ione	Falcon
Gilma	Rains
Lupita	Wallen
Renata
Catalina	Wagoner
Moises	Schubert
Aimee	Stovall
Evita	Ashton
Avery	Sweat
Melodi	Mesa
Maynard	Johns
Elfreda	Dowdy
Rochel
Leilani	Carlisle
Maritza	Williford
Jeraldine	Kinard
Tonja	Slattery
Carmella	Wheatley
Yasmin	Wasson
Melia	Beaty
Tammera	Crutchfield
Susanna	Wirth
Rosy
Jocelyn	Naquin
Frederica	Kendall
Trinidad	Hull
Lawanda	Jean
Arden	Haag
Loree	Nickerson
Adelina	Mclendon
Abigail	Goldsmith
Victor	Walden
Rosamond	Fellows
Raymundo	Hatfield
Debbra	Hemphill
Sam	Mcgovern
Zack	Snider
Jestine	Kerns
Tammara	Hickman
Samuel	Hales
Seema	Mosier
Dion	Rickard
Kermit	Keenan
Lidia	Poland
Shiloh
Neely	Branham
Lucila	Madrigal
Shanelle	Stearns
Odilia	Metzler
Charlette	Dion
Min	Byers
Elwanda	Barraza
Gonzalo	Sorenson
Marquis
Delisa	Roark
Pamelia
Adan	Brennan
Lecia	Whitlock
Prudence	Minnick
Bobette	Kaufman
Walker	Sturgill
Rosendo	Orourke
Pearle	Altman
Jeremy	Schweitzer
Latosha	Sasser
Londa	Pond
Vennie	Titus
Lavona	Thayer
Chelsie	Olivas
Argelia
Chaya	Brant
Keenan	Cheek
Keitha	Bain
Rodrigo	Lightfoot
Jules	Knox
Cira	Beckett
Desirae
Douglass	Ledbetter
Silas	Saucier
Velva
Kristyn	Halverson
Katina	Keck
Selena	Stinnett
Pricilla	Parkinson
Paris	Siler
Etha	Felix
Elvia
Florida	Runyon
Daine	Wakefield
Shavonda	Nieto
Danilo	Burdette
Britteny	Hoy
Diann	Escobar
Ka	Willett
Muoi	Fugate
Hilary	Shelby
Lucretia	Lessard
Evelin	Hough
Rebekah	Ferris
Imogene	Duran
Burma	Dobson
Ulrike
Donya	Speer
Shellie	Queen
Johna	Lance
Stephenie	Baggett
Nia	Gulley
Agnus
Launa	Armijo
Shirely	Spruill
Herminia	Carrier
Carmine
Rossana	Fitzsimmons
Laquanda	Amaral
Serena	Hendrick
Felecia
Normand	Esposito
Shemeka	Bateman
Leoma
Tyson	Manley
Shara	Buss
Mary	Wicks
Jamaal	Kruger
Josef	Prosser
Loren	Rand
Trula	Barksdale
Toby	Sampson
Ellis	Wooldridge
Kourtney	Kelso
Mai	Briseno
Mayme	Coley
Miguelina	Velasco
Glennie	Heim
Beatris	Hobson
Shelli	Rosado
Vanesa	York
Sunni	Lentz
Alethea	Kearney
Leone
Ilda	Findley
Christiane	Ainsworth
Karma	Ruff
Nanci	Andres
Neta	Pearce
Emmanuel	Meehan
Antony
Glynda	Hanes
Wesley
Ula	Morey
Dimple
Elidia	Rowell
Sherrill	Morrell
Susana	Smalls
Aurea	Lincoln
Odelia	Johansen
Sadye	Hurtado
Galina	Berlin
Jack	Weed
Stanton	Bassett
Lucienne
Rory	Walter
Keely	Wilmoth
Magdalen	Mcmurray
Noelle
Isiah	Brice
Phylicia	Strother
Tameka	Bruner
Lucius	Garmon
Yaeko	Frizzell
Dalila	Cho
Cathey	Bordelon
Alverta	Seaman
Lonnie	Esparza
Lesia	Ho
Shila	Ricker
Izetta	Edmondson
Kymberly	Perryman
Raylene	Mcclelland
Penelope	Otis
Adell	Cloutier
Alissa
Yajaira	Strauss
Aubrey
Jacquelin	Matson
Rubie	Watters
Talitha	Sawyer
Grover	Underhill
Portia	Dees
Hobert	Mcknight
Marquita	Irby
Terra	Baez
Alexis
Kristian
Domenica	Forrester
Oren	Berryman
Ty	Sloan
Tonda	Boynton
Breanna	Lapointe
Ellena	Mackey
Samatha
Charlsie	Parnell
Sharika	Boyle
Merri	Lindquist
Scottie	Pierson
Mi	Rivas
Malik	Fitch
Marivel	Pino
Chet	Paige
Lacey
Maryjo	Hatton
Kamilah	Atherton
Jewel	Worthy
Azucena	Shinn
Damaris	Cherry
Brandon	Branson
Jacinto	Edge
Clarence	Mcinnis
Madeleine	Kiefer
Mireille	Schaeffer
Deloise	Hutcheson
Austin	Hamby
Jame	Mcnamara
Niki	Saldana
Donte	Staten
Rickie	Bull
Andrea	Noel
Charis
Gabriele	Ketchum
Sherie	Loomis
Jamison	Laplante
Brice	Hamblin
Katlyn	See
Hae	Smallwood
Vi	Carnahan
Oretha
Pennie	Chau
Lolita
Melisa	Shumaker
Tova	Merrill
Zada	Coffin
Lan	Patel
Flor	Grubb
Evelynn	Forsythe
Hettie	Roth
Sha	Emanuel
Lashaun	Looney
Fabiola	Montanez
Johnetta	Mcnulty
Lavern	Montague
Deane	Jarrell
Beau	Provost
Hassan
Ngoc	Steed
Calandra	Briscoe
Kip	Lantz
Leonida	Greenberg
Renate	Dickson
Carmen	Orozco
Natosha	Brinkman
Peggie	Foss
Mitzie	Goulet
Jimmy	Staples
Octavio	Garvey
Herschel	Mcneill
Meridith	Prieto
Gricelda	Rosser
Myrtis	Geiger
Kelley	Loveless
Benito	Shepard
Frederic	Broderick
Arnette	Rouse
Genevive	Baines
Nerissa	Frantz
Hollis	Mohr
Alba	German
Mendy	Tracy
Tamar
Roseanne
Mina	Augustine
Daron	Forte
Alisia
Dong
Brianna	Jordon
Jasmin	Rodrigue
Joan	Heinz
Duncan	Southerland
Griselda	Oldham
Willy	Gaffney
Ghislaine	Greenwood
Jospeh	Borders
Debora	Valle
Arnita	Bryson
Alayna	Pleasant
Ivonne	Rosenbaum
Asia	Derr
Jerry	Osullivan
Gia
Lizbeth
Norris
Alejandrina
Margarite	Weiner
Queenie	Bird
Darcy	Nesmith
Lindsay	Ransom
Malika
Gil
Bess	Barclay
Willette	Ulrich
Rosario	Kirk
Sarai	Weldon
Many	Peacock
Lavette	Lu
Laure	Sommer
Caterina	Beckham
Rickie	Thomsen
Jessia	Petty
Keven
Joeann	Caudle
Jacquline	Burkhart
Ramonita	Mccloskey
Ester	Teal
Oscar	Deloach
Eldora	Dewey
Georgene	Shultz
Yulanda
Clementine	Woodworth
Merilyn	Dugas
Brittni	Camacho
Lorenza	Prescott
Darnell	Thames
Timothy	Najera
Latasha	Lerma
Ellie	Wilks
Corrina	Puckett
Linsey	Bloom
Demetria
Kris	Mccombs
Caroll	Raines
Lindsey	Newkirk
Deloris	Katz
Sharron	Loyd
Christene	Matlock
Amada	Noriega
Dean	Gamble
Librada
Dwain	Pettis
Usha	Yi
Tora	Creamer
Kiesha	Hussey
Georgeanna	Simpkins
Anamaria	Dow
Dionne
Harriette	Krause
Williemae
Akilah	Kaminski
Lyla	Crowley
Vito	Frye
Antione	Lange
Kandis	Vigil
Monte	Nolen
Shiela
Whitney	Goins
Annamae	Nealy
Katheryn	Tilton
Aletha	Pagan
Scot	Jung
Efrain	Younger
Mazie	Kent
Roxy	Soares
Dawna	Loving
Ursula
Kristan	Albrecht
Brigitte	Magana
Shelton	Keel
Ailene	Vue
Shanell	Dailey
Laurel
Margherita	Fusco
Cathie	Cade
Azalee
Patience	Corcoran
Alvera	Earl
Alexia	Stjohn
Ena	Sylvester
Lavonda	Davison
Kiley	Spicer
Albertina	Dunne
Ashton	Ayres
Thaddeus	Gamboa
Azzie	Bowlin
Joanie	Alger
Jeanmarie	Pipkin
Carson	Schmid
Wilmer	Skelton
Thora	Peel
Delmy	Jaramillo
Charlesetta	Battaglia
Regenia	Ernst
Magnolia	Cavazos
Juliane	Vines
Bennett	Shores
Elois
Socorro	Cramer
Fidela	Batchelor
Toccara	Kruse
Anibal	Joy
Staci	Tyson
Takisha	Thao
Jolanda	Leak
Genie	Easley
Lisandra	Roberge
Tamisha
Teisha	Carl
Neva	Cuellar
Moon	Booker
Garland	Sessions
Reba	Tirado
Estrella	Rosa
Naoma	Chase
Yesenia	Scarbrough
Mitchel	Mcmahan
Chassidy	Nesbitt
Annis	Mansfield
Mathilda	Cornett
Mohamed	Lockwood
Cheryle	Bundy
Rosita	Huddleston
Thu	Coon
Tangela	Field
Emely	Blanchard
Kory	Donald
Nevada	Whitlow
Lennie
Richelle	Oshea
Mitsuko	Harry
Barrie	Pickens
Tanna	Pence
Ines
Analisa	Pettit
Narcisa
Pok	Ashby
Delfina	Nabors
Tess
Jerrod	Hensley
Long	Enos
Marcelina	Morin
Freddie	Brockman
Rachal	Glenn
Moira	Montez
Brant
Ashely	Carney
Chin	Dykes
Tonita	Thrash
Jenise	Beltran
Joselyn	Fife
Letty	Hooks
Dorcas	Deaton
Ashlea	Baugh
Lovie	Hacker
Cinthia	Mccaskill
Addie	Wingfield
Shemika	Brubaker
Ned	Calabrese
Melida	Hubert
Sol	Ahrens
Micah	Childress
Ileen	Berube
Miesha
Lemuel	Moye
Jacquie	Truong
Tona	Wolff
Dena	Mize
Natalia	Calvin
Valene	Allman
Rina	Cooney
Lakeshia	Gifford
Sanford	Devito
Merry	Mcallister
Candy	Fulmer
Alta	Mcarthur
Eusebio	Street
Angele	Friedman
Jess	Rosenthal
Cristi	Melancon
Echo	Bunch
Nada	Weathers
Kathern	Crosby
Tanner	Martz
Leo	Winters
Tomi	Quigley
Alina	Seymore
Aliza	Sheridan
Chandra	Mccord
Brittaney	Dover
Erich	Petersen
Juliann	Head
Jason	Earle
Kizzy	Perreault
Enid	Villasenor
Denisha	Gallagher
Shantelle	Rushing
Brendon	Ostrander
Pei
Wenona	Pendleton
Tien	True
Latrisha	Girard
Bridgette	Camarillo
Theda	Packer
Linwood	Kee
Jeannine	Robinette
Milly	Artis
January	Frazer
Kristal	Ouellette
Stasia	Hyde
Hayley	Alcala
Lavone	Kirby
Cheryll	Pepper
Julio
Flossie	Ivey
Madie	Skipper
Eun	Canada
Lise	Waggoner
Carman	Mcclintock
Samara
Jeana	Charles
Chung	Preston
Gregory	Stanford
Leida	Royal
Harrison	Stowe
Shirly	Garrison
Dorris	Mcdaniels
Blythe	Will
Petra	Antonio
Letha	Sage
Sharmaine	Napier
Nicky	Kaplan
Kalyn	Martens
Amberly	Catalano
Debi	Bruce
Joane	Hopper
Livia
Reyes	Frick
Earlean	Whitney
Lucina	Ring
Estella	Windham
Kaitlyn
Shirl	Swartz
Florencio	Spring
Anisa	Snead
Tama	Chin
Kurtis	Laflamme
Luna	Fortner
Francoise	Halcomb
Jackelyn	Bergstrom
Millard	Beale
Tarsha	Kenney
Shanon
Lorita	Wenzel
Krysta	Combs
Pia	Gatewood
Louetta	Dabney
Young	Shrader
Carylon	Porterfield
Gertie	Henley
Karie	Vang
Kenyetta	Doughty
Lelah	Mackay
Allene	Grier
Marge	Place
Tinisha	Parish
Johnny	Rivers
Roxann	Myrick
Rubye	Rich
Tenisha	Godwin
Burt	Jamison
Hildegarde	Elrod
Agatha
Olinda	Glynn
Dennise
Brock	Mortensen
Dara	Ragsdale
Tu	Jacks
Lon	Barrera
Elicia	Forsyth
Marilee	Bustamante
Libby	Crowder
Millicent
Jeni	Wilhelm
Sheree
Yuko
Clemente	Luther
Norene	Bowden
Evon	Barry
Yuki	Stacey
Ileana	Whittaker
Carolee	Li
Reva	Newsome
Thomasena	Linton
Georgie	Alston
Devorah	Quinones
Etsuko	Adcock
Rolf	Means
Gena	Aranda
Paulene	Stidham
Kaye	Doran
Porsha	Moseley
Felice	Brumfield
Lucie	Elizondo
Lekisha	Crider
Elenor	Busch
Shameka	Reyna
Natacha	Buck
Hildred	Langlois
Marg	Schaefer
Maryanna	Sterling
Fairy
Emilie	Ragan
Devon	Pfeifer
Yang	Samuels
Madison
Lorie	Ashcraft
Tomasa	Clay
Marguerita
Marlana	Decker
Hester
Ayana	Harman
Rigoberto
Zaida	Sykes
Esteban	Reddick
Gregorio	Christenson
Corene	Escalante
Felica	Neumann
Syble
Ressie	Waldrop
Candis	Heck
Carline
Alane	Conaway
Meggan	Durbin
Shanta	Olmstead
Audria
Foster	Newcomb
Mellissa	Wren
Adriene	Rohr
Frank	Hendrix
Evelia	Gorman
Valeria
Scotty	Lombard
Amiee	Meek
Mitsue	Houck
Jesusita	Dollar
Houston
Nita	Eller
Nathanael	Wynn
Dani	Cochrane
Ima	Mcmillen
Zackary
Manual	Vu
Noma	Mowery
Burl	Stubbs
Andrew	Carman
Tiana	Mireles
Linn	Stegall
Song	Moll
Marine	Nye
Jefferey	Key
Yoshiko	Rosenberg
Jeanie	Ahern
Rikki	Baum
Johnette	Barnette
Coral	Schilling
Jeffrey	Rubio
Effie	Duckworth
Arlen	Cranford
Jamey	Leone
Suzanna	Bradshaw
Hee	Barlow
Anton
Angla	Baxley
Russell	Corrigan
Sherita	Mancuso
Zella	Rupp
Lexie	Wellman
Jazmine
Weldon	Mclain
Karena	Scales
Juliana	Otoole
Winnie	Spurlock
Leonila	Neill
Lewis	Coble
Belen	Daily
Darcel	Nowak
Charity
Marquitta	Rasmussen
Elizbeth	Grimes
Daphne	Yazzie
Romona	Ngo
Chere	Helm
Renna	Milligan
Linnie
Star
Tracie	Lancaster
Lona	Murry
Katy	Chance
Heidy	Becerra
Carlena	Motley
Jonah	Browning
Tyron	Kopp
Michaela	Nicholas
Britta	Grover
Jennette	Grayson
Wilton	Lacy
Hai
Carey	Fishman
Annamarie	Duffy
Hosea	Ewing
Kathlyn	Sheehan
Penni	Shay
Napoleon	Strand
Valorie	Stump
Kasey	Schaffer
Larry	Harrell
Boyce	Navarrete
Cordelia	Dobbins
Rene	Estep
Odell	Palacios
Shoshana	Navarro
Lakeisha	Pham
Kassandra	Biggs
Merrill	Reynoso
Milo	Feliciano
Ammie	Calkins
Sirena	Shoemaker
Kerrie	Templeton
Robert	Thurston
Deshawn	Bonilla
Paige	Person
Ciera	Legg
Marvel	Gagne
Cletus	Cambell
Mohammad	Falls
Rozella	Santana
Maxie	Coffman
Soraya	Luster
Monika	Rojas
Joycelyn
Adelaida	Verdin
Chloe	Self
Jc	Parra
Gwenn	Word
Trenton	Fincher
Veda	Blanco
Vergie	Overstreet
Dannette	Moeller
Natividad	Kirkland
Sherise
Bibi	Childers
Nakita	Yoon
Loni
Louvenia	Marin
Ling	Paulson
Carmelina
Sterling
Lauri	Wills
Marlen	Meyers
Davida	Clinton
Vinita	Caro
Torrie	Slack
Jone	Givens
Dottie	Nielson
Kirby	Dangelo
Mittie	Ireland
Kristle	Ledesma
Taren	Pate
Justina	Lytle
Mafalda	Driscoll
Orpha	Whitten
Elvin	Pannell
Valery	Hayward
Blake	Dorris
Josefine	Lawless
Shan	Troutman
Mauricio	Herzog
Gemma	Flaherty
Mikel	Parham
Martine	Weeks
Shana	Hickson
Boris	France
Willodean	Horan
Bart	Kramer
Carmelita	Shell
Chase	Moya
Yer	Higgs
Tessa	Marroquin
Ayako	Numbers
Jarrod	Keeton
Norberto	Contreras
Tori	Arnett
Keshia	Tom
Stan	Daly
Maxima
Graciela	Coe
Regine	Elmore
Lia	Schott
Rosalba	Cummins
Lyn	Peace
Devora
Olevia	Sam
Ayanna	Truitt
Mila	Le
Noelia	Becnel
Siobhan	Roman
Enoch	Pullen
Marya	Shuler
Fred	Rader
Chance	Salter
Shani	Babb
Elisha	Riddick
Colby	Quarles
Audra	Armenta
Alysa	Nixon
Zoe	Browne
Emory	Beyer
Caron	Hearn
Pattie	Goodson
Eliz	Kern
Celsa	Nation
Xenia	Rife
Malia	Epperson
Kyoko	Segura
Fleta	Ahmed
Particia	Giroux
Porter	Whitley
Russ	Snipes
Coy	Cowart
Aleida	Nevarez
Jaimie	Crowe
Porsche	Tatum
Pinkie
Sammie	Bigelow
Kristeen	Bower
Julian	Richey
Miyoko	Craddock
Jenae	Gilliland
Palmer	Stclair
Micheline	Burris
Billie	Bowens
Cristopher	Whitehurst
Sina	Sisk
Alena
Stephaine	Meeker
Herma
Jina
Hallie	Clements
Vaughn	Thrasher
Celine	Medeiros
Na	Boatwright
Gema	Large
Kathlene	Meredith
Alessandra	Amaya
Chong	Battle
Gillian	Edward
Natalya	Hester
Carl	Wiggins
Shane
Eliana	Lanham
Bunny	Benoit
Conchita	Shaver
Latonya	Agee
Lauretta	Benavides
Denna	Gilmore
Mercy	Buckner
Roni	Edgar
Rosalyn	Morehead
Wes	Farrington
Mistie
Tempie	Melvin
Carlo	Adler
Randa	Webber
Coletta	Beeler
Stephine	Couch
Huong	Devine
Marica	Heaton
Cleopatra	Carnes
Rosalina	Wiles
Melita	Costello
Ethyl	Quintana
Susanne	Hammer
Carol	Sands
Reena	Belcher
Carry	Ashley
Windy	Salcedo
Lawanna
Norbert	Forbes
Lorrine	Hershberger
Diedre	Pace
Kathline	Adame
Cassidy	Willey
Maris	Daley
Princess
Karrie	Lozano
Joetta	Alderman
Marisa	Kelleher
Arla	Hitt
Francesco	Mundy
Chantell	Burkholder
Violette	Robison
Latesha	Judd
Estefana	Lemon
Erminia	Boyles
Rosaria	Fournier
Rosena	Kane
Fay	Hewitt
Antonio	Freitas
Bennie	Leger
Katherina	Buckley
Glendora	Bui
Tisha	Osburn
Rachell	Leyva
Breann	Clarkson
Quyen	Hamer
Hildegard	Salas
Vicenta	Noonan
Samual	Breeden
Lurlene	Archie
Yadira	Munn
Maryanne	Withrow
Deandra	Crain
Pauletta	Shepherd
Genesis	Pippin
Trista	Boss
Eura	Baughman
Albert	Moriarty
Tijuana
Allyson	Davies
Ardis	Wilbur
Tyra	Dodson
Lorina	Samuel
Yon
Hwa	Talley
Jae	Mercier
Erinn
Marcelino	Begley
Mac	Shields
Doretta
Elva	Woodward
Latrina	Heard
Franklyn
Junior	Ly
Fabian	Lindley
Marisol	Coppola
Eusebia	Lyon
Gabrielle	Sinclair
Marketta	Fredrickson
Carmon	Shank
Maricela	Harley
Tommy	Cabral
Ardath	Boothe
Latarsha	Mattingly
Elly	Kong
Hana	Sewell
Youlanda	Register
Sherley	Durr
Janiece	Burleson
Asley	Sales
Tameika	Kohl
Denyse	Puente
Roselle	Gass
Merrie	Hummel
Amal	Wild
Ozell	Andrus
Blaine	Strunk
Vannesa	Saylor
Melvin	Arias
Brigid	Fredericks
Savanna	Buford
Terese	Steinberg
Emelina	Vogel
Xavier	Castellanos
Sunny
Zulema	Milam
Clarinda	Nall
Kaci	Block
Tennille	Giles
Darius	Rickman
Norine	Halsey
Kaycee	Cass
Horacio	Mcclendon
Isaias	Weiss
Cyrus	Quiroz
Lilli
Yelena	Smart
Thalia	Bragg
Bernie	Mcvay
Bernardine
Stephane
Gabriella
Tawna	Harms
Lavenia	Weems
Tasia	Kirchner
Shante	Hadley
Danyel
Ronald	Merritt
Idalia	Batten
Taina	Varner
Saundra
Mellisa	Culver
Cicely	Gallegos
Fransisca	Neely
Cedrick	Croft
Magali	Beals
Kenya
Janey	Joe
Lane	Lyle
Maribel	Ratliff
Marti	Urban
Walter	Milne
Loida	Morse
Lesha	Tinsley
Mickey	Hidalgo
Tamiko	Eaton
Ela	Thibodeaux
Shirleen	Schulz
Sherell	Lau
Buffy	Jarrett
Lesli	Mccloud
Shea	Wu
Lester
Darcie	Bohannon
Denita	March
Loriann	Chung
Michiko	Toth
Suzi	Witherspoon
Alise	Hoang
Reatha	Eckert
Ilene	Angel
Malcom	Cushman
Lucien	Levine
Nguyet	Bourne
Tomika
Herb	Brittain
Claretta	Harden
Louanne
Devona	Carrington
Ehtel	Cantwell
Ronda	Ennis
Dick	Pickard
Laci	Ventura
Danae
Giovanna	Silvers
Trinh	Myles
Alda	Howe
Ocie	Strong
Tatiana	Dunham
Deedra	Bernstein
Jeri	Fair
Toya	Dockery
Alonso	Karr
Myrta	Meadows
Verena	Stamper
Nannie	Tillman
Gwenda	Lattimore
Paris	Farnsworth
Liberty	Cooley
Hilario	Oconner
Marnie	Richter
Brooks	Southard
Rosann	Sperry
Leeanne	Cyr
Aida	Lebron
Aleen	Isom
Candra	Luce
Classie	Hope
Diamond
Palma	Nobles
Ta	Hess
Dierdre	Cavanaugh
Macy	Burrell
Carola	Worth
Janita
Raymon	Crouse
Retta	Pitt
Sacha	Schumacher
Cruz	Croteau
Maude	Kovach
Bari	Madison
Victorina	Lehman
Jamar	Barger
Leigha	Hardin
Mirian
Maryetta	Koenig
Elodia
Sandie	Poe
Yan	Galindo
Tonie	Neeley
Gayle	Copley
Somer
Susy	Oates
Larita	Herbert
Elinore	Grove
Arletta	Triplett
Avelina	Kingsley
Yun	Quezada
Teresita	Mccullough
Kimbery	Carmona
Hank	Mullen
Willow	Hutto
Iona	Denny
Delilah	Acosta
Tillie	Conway
Mikaela	Taggart
Granville	Mckinley
Harlan	Caballero
Noe	Emerson
Inell	Payton
Mariam	Phelan
Theola	Mccall
Cyndy	Larose
Hermine	Estrella
Rena	Lanier
Hyman	Byars
Lesley	Mims
Royal	Rounds
Serafina	Jude
Janina	Boswell
Adriane	Inman
Rhett	Moen
Fumiko	Pool
Janine
Roxie	Rosales
Kieth	Smoot
Hollie	Hinton
Yevette	Holiday
Loura	Kitchens
Dante	Redden
Tamatha	Arrington
Sharan	Layne
Vanetta	Hughey
Leena	Haywood
Maisha	Huynh
Autumn	Lucero
Easter	Harp
Sharilyn	Jorgenson
Shelby	Warden
Micaela	Odom
Lane	Winfield
Adolph	Piper
Charmain	Berger
Ahmad	Noble
Bernardo
Columbus	Baron
Santos	Longoria
Stefania	Ludwig
Humberto	Unger
Ara	Benner
Wendie	Ison
Earline	Hancock
Felicitas	Paterson
Kimberlee	Skaggs
Suzan	Luciano
Monty	Prewitt
Ezequiel	Crocker
Shanice	Slagle
Jacklyn	Mclaurin
Cuc	Monk
Tommie	Paredes
Kelle	Vetter
Nell	Mckinnon
Matha	Hsu
Maisie	Earls
Adeline	Emmons
Renea	Gleason
Johnie	Lilly
David
Alvina	Nunes
Desmond
Florance	Melendez
Edmundo	Roper
Dedra	Hammons
Iesha
Evia	Jorgensen
Minerva	Holloman
Chau	Steadman
Wilburn	Burks
Garth	Reddy
Darrick	Otto
Joya	Yancey
Burton
Larissa	Albert
Ashlee	Goad
Sherlene	Andre
Abbey	Fiore
Dominga	Rubin
Shyla
Ariel	Wilhite
Osvaldo	Kuhn
Dorotha	Lynn
Kasha	Currie
Helaine	Archibald
Kiyoko	Dempsey
Janessa	Willingham
Winona	Carvalho
Aurelio	Kohler
Heriberto
Rosio
Polly	Donnell
Andre
Pasquale
Laraine	Hawthorne
Kortney	Kinsey
Chi	Julian
Louann	Sledge
Georgiana
Elnora	Basham
Karry	Bellamy
Khadijah	Lilley
Leesa	Tabor
Tory
Doreatha	Downing
Joana
Zina	Sweeney
Reagan
Wei	Justus
Major	Guenther
Danyelle
Elwood	Easterling
Sherilyn	Dodd
Audrea	Flint
Berneice	Steiner
Sharolyn	Lawler
Farah	Penn
Simonne	Leal
Nila	Centeno
Gene	Parson
Kai	Fish
Drusilla	Cartwright
Qiana	Stuckey
Yu	Valencia
Aurelia	Beavers
Arlette	Moulton
Denae	Barth
Ingeborg	Hilliard
Genevie	Fonseca
Cortez	Levesque
Bradly	Mccormack
Elmer	Murillo
Edwina	Devries
Margret	Cruse
Donny	Cleveland
Kesha	Rees
Sherika	Negrete
Latricia	Aragon
Lazaro	Galvan
Mira	Foret
Marcellus	Rucker
Daniella	Rust
Willa
Lonny
Gerda	Lam
Maryellen
Lesa	Mcgrew
Annetta	Seal
Nicolasa	Fitzpatrick
Jere	Burch
Linnea	Wylie
Piedad	Aviles
Dotty	Winkler
Emogene	Mcclung
Rhoda	Gavin
Oliva	Radford
Phung	Herr
Teena	Mckenney
Quiana	Eldridge
Nestor	Blodgett
Adina	Baer
Dorthy	Alley
Chieko	Hills
Manuela	Mahan
Carleen	Roden
Misti	Damron
Simone	Charlton
Eboni	Elliot
Talia	Crump
Arnetta	Shipley
Tracee	Valles
Jenice	Miranda
Trinidad	Sena
Tequila	Rigsby
Tiffaney	Reaves
Earnestine	Shore
Augustine	Oh
Doretha	Cable
Bee	Schafer
Keli	Pollock
Jacque
Paul	Woodson
Elsy	Chappell
Shae	Sample
Vita	Mayfield
Alphonse	Post
Geralyn	Gregg
Maximo	Nutt
Erwin	Cintron
Orval
Patrica	Kurtz
Meagan	Ervin
Quinton	Luttrell
Cherie	Jett
Krystle
Hanna	Cooke
Demetra	Massie
Contessa	Potts
Novella	Goldberg
Onita
Zona	Thiel
Salley	Craft
Sona	Champagne
Jule	Heath
Kitty	Kilpatrick
Antonina	Hudgens
Kassie	Barden
Brittney	Walling
Janette	Newsom
Sylvie	Stockton
Lenard	Hankins
Fern	Oreilly
Cristin	Acevedo
Adelia	Culp
Jada	Keane
Louisa	Andrew
Dia	Hobbs
Wava	Mcleod
Claud	Tuttle
Vania	Rinehart
Indira	Kellogg
Magda	Wheat
Madonna	Ohara
Dalene	Booth
Robena	Littlejohn
Kia	Sanborn
Dung	Stapleton
Luciana	Clem
Sharleen	Limon
Mia	Frierson
Avis	Flanders
Hoyt	Poore
Providencia	Ledoux
Cheri	Rapp
Jenni	Scoggins
Maudie	Nugent
Astrid	Carlos
Abbie	Bertram
Shaina	Schofield
Emile	Lim
Wai	Spearman
Hilma	Mcneely
Chante	Larry
Gertrud	Burge
Elease	Gould
Grayce	Schrader
Mandi	Riggs
Iola	Schroeder
Eloisa	Huntington
Shalanda	Holton
Karole	Lemaster
Christa	Pereira
Stepanie	Hutchinson
Meghann	Logsdon
Marlys	Felder
Mackenzie	Chester
Stephany	Hitchcock
Eddy	Gardiner
Cori	Goddard
Venus	Fairchild
An	Burkett
Honey
Evelyne	Francois
Mckinley	Wilkinson
Elmira	Marquis
Del	Geer
Leila
Garret	Faust
Tanja	Jaynes
Lai	Mattson
Ariane	Gaines
Dorla	Hutchins
Mara	Hightower
Ilana	Crisp
Noriko	Rainey
Rea	Bagley
Anja	Horowitz
Liliana	Acuna
Lera	Garvin
Brook	Dye
Dayna	Burt
Ona	Omalley
Zoila	Alcorn
Jenelle	Hudgins
Riva
Mariko	Foy
Leonora	Valadez
Edelmira
Sheryll
Dominque	Crane
Alease	Bogan
Terisa	Partridge
Dolly	Pritchett
Nubia	Sheets
Hung
Lyndsey	Blakely
Jennefer	Mcdowell
Jannette	Spears
Alesia	Matthew
Shanti	Sheffield
Camie	Lombardo
Magen	Chalmers
Lillia	Dupre
Alphonso	Pinkston
Hiedi	Griffis
Yahaira	Gallant
Noble
Junie	Bone
Kenton	Neville
Margene	Hutson
Gudrun	Oakley
Liane	Jenson
Asha	Kellum
Allegra
Shakira	Vaughan
Tia	Davenport
Elizebeth	Lay
Zenaida	Mathews
Aundrea	Grossman
Klara	Grady
Isadora
Cherryl	Shade
Troy	Garber
Gilberte	Beane
Federico	Mccurdy
Beverlee	Bartlett
Kareem	Tolliver
Shakita	Marr
Lanita	Vaught
Delsie	Mauro
Katheleen	Chavarria
Terrilyn	Delatorre
Wilhelmina	Koch
Jaye	Furr
Natisha	Hawks
Roseanna	Milburn
Synthia	Cervantes
Logan	Mcwilliams
Corina	Betancourt
Kevin	Power
Tommye	Gaddis
Evette
Janene	Broyles
Verline	Dorman
Teofila	Lombardi
Tonette	Ayala
Belle	Metcalf
Gaynelle	Talbot
Cris	Corona
Lea	Stock
Magdalena	Bible
Allie	Still
Will	Greathouse
Emil	Flanagan
