Jesusita	Milne
Yer	Justice
Analisa	Church
Nikia	Bueno
Leola	Mccarter
Hassie	Sawyers
Phillis	Mcleod
Aleisha	Waller
Obdulia	Finnegan
Nyla	Staples
Julienne	Devine
Lizzette	Keeling
Tomika	Baum
Sulema	Shapiro
Dacia	Cornell
Kathlene	Kunkel
Jayme	Barr
Halina	Dykes
Denyse	Cordova
Rachelle	Sewell
Mark	Pickard
Cristopher	Wofford
Serina	Ketchum
Nguyet	Mancini
Daniel	Combs
Roslyn	Lacy
Odessa	Cotter
Romeo	Hackett
Cathleen	Franz
Domitila	Pritchard
Jerrie	Luckett
Glynda	Fitch
Lino	Barkley
Charlyn	Hamlin
Tynisha	Montez
Golden	Cato
Karl	Sams
Jalisa	Harrell
Jordon	Register
Paulina	Mcmullen
Wilton	Yang
Elizbeth	Ragland
Alayna	Abrams
Rosanna	Echevarria
Tawna	Van
Gerri	Lowell
Adelina	Prather
Pearlene	Rust
Arnoldo	Balderas
Bobby	Limon
Bettyann	Madden
Diann	Pina
Shana	Garvin
Marth
Nancey	Clegg
Fabiola	Metcalf
Emmaline	Orourke
Erin	Serrano
Kai	Spain
Deedra	Coy
Jule	Bauer
Nathanial	Massie
Bell	Lockhart
Rana
Chanel	Nunley
Summer	Hussey
Wyatt	Dew
Letha
Ina	Sepulveda
Marry
Ariana	Leighton
Yuriko	Schaefer
Gabriele	Finley
Onie	Seay
Tristan	Strauss
Janel	Arce
Reynalda	Barham
Mayme	Witt
Kiersten	Kasper
Lorilee
Mia	Cone
Theola	Rocha
Jeromy
Denese	Chamberlain
Mi	Herring
Samuel
Bettina
Lakita	Hyland
Cheryle	Pringle
Lili	Mallory
Nakesha	Wills
Lucrecia	Hare
Rossie	Albert
Jovan	Gilliland
Filomena	Gold
Elden	Brumfield
Harland	Lundberg
Dodie	Reich
Michael	Francois
Mallory	Platt
Luana	Peterman
Shelby
Dann	Wentworth
Justina	Towns
Synthia	Townes
Daniele	Dunham
Michaele
Florencio	Kenney
Loyd	Cranford
Kandi	Sherwood
Pearline
Elissa	Martindale
Shaunte	Gamble
Clarinda
Virgina	Warfield
Porsha	Oliphant
Ula	Beale
Enola	Keating
Bethel	Angulo
Tracie	Gannon
Debera	Carder
Mellie	Sandlin
Jettie	Martel
Magali	Bounds
Shayne	Bartholomew
Lory	Fine
Roseline	Seifert
Elwanda	Dayton
Silva	Swartz
Marla	Belt
Cicely	Ivey
Genoveva	Ralston
Shayne	Heinz
Allegra	Pennington
Merissa	Barba
Keith	Perron
Delorse	Hollis
Dong	Lennon
Nereida	Dial
Wynona	Greenfield
Gaynelle
Jolene	Glynn
Deneen
Camilla	Merritt
Criselda	Boudreaux
Donovan	Crist
Erna	Hand
Twana	Dye
Leigha	Barrow
Jodee	Vera
Rubi	Grey
Merrie	Starkey
Ceola	Madison
Donte	Soriano
Mose	Godfrey
Modesta	Beauregard
Corinne	Manley
Shan	Dove
Lynell	Gerard
Merideth	Bui
Kasey	Royer
Madalene	Connors
Cheryll	Coburn
Jesse	Galloway
Grayce	Armstead
Glennis	Bayer
Nubia	Bachman
Terrilyn	Ruby
Velda	Trotter
Jann	Guerin
Lupe	Rutherford
Lelah	Childress
Katharyn	Upton
Richelle	Wadsworth
Nannie	Hooker
Tabatha	Arroyo
Vincenza	Nye
Edie	Knoll
Emmy	Torrence
Meryl	Moon
Marissa	Maas
Deena	Romo
Rochel	Dillon
Shondra	Mears
Dion
Monika	Thibodeaux
Elva	Moe
Oneida	Crutcher
Halley	Prince
Rico	Curran
Arminda	Goforth
Alejandra	Herr
Giovanna
Veronika	Lattimore
Lashon	Saenz
Ellamae	Strand
Chantay	Colson
Cecil	Rosado
Salina	Davila
Jacquline	Bedard
Tanna	Gilley
Lita	Peeples
Roxana	Nieves
Luis	Gerald
Librada	Blanchette
Shaina	Nielson
Stacia	Hensley
Leandra	Cosby
Dee	Thomsen
Kisha	Chastain
Dong	Shafer
Jacklyn
Elyse
Consuela	Padgett
Tonda	Corley
Letty
Jeanetta	Prosser
Ermelinda	Bethel
Vanesa	Bradford
Mai	Luster
Jacinto	Gustafson
Clarisa
Sharmaine	Hassell
Rod
Yuk	Magee
Adeline
Shamika	Mays
Claudette	Wolff
Herta	Schmid
Remedios	Grubbs
Millie	Doll
Ricarda	Gaylord
Rosaura
Anh
Arletha
Cortez	Archer
Karine	Albers
Kylee	Compton
Sasha	Bacon
Eneida	Puckett
Chang	Braxton
Camila	Hartmann
Carolynn
Kaylene	Lira
Shelli	Winstead
Renna	Witte
Elizabet	Briscoe
Carola	Shackelford
Illa	Whitworth
Wai	Seymore
Maryalice	Hibbard
Mohamed	Girard
Deandre	Whaley
Phoebe	Mintz
Latosha	Parnell
Telma	Hills
Kristle	Pierre
Racheal	Chapa
Alfonzo
Hassan	Myrick
Ardith	Orosco
Altha	Gillette
Clyde	Gil
Christopher
Junko	Bolduc
Kira	Juarez
Thao
Venus	Winfield
Justin	Boatwright
Kelle	Freund
Jolyn	Newcomb
Libby	Stephen
Lyda	Lunsford
Gwyneth	Mccaskill
Josef	Conklin
Lazaro
Neta	Goodson
Andrew	Varela
Elke	Rhoads
Rebekah	See
Corey	Scruggs
Hayley	Goulet
Kathe	Yount
Hong	Driscoll
Val	Winfrey
Sharie	Tremblay
Liz	Wiseman
Shery	Hindman
Kathryne	March
Emile	Mchenry
Jovita	Tyner
Ranae	Thornhill
Simona	Vines
Kerrie
Thomasine	Cleveland
Shonna	Steiner
Yajaira	Donaldson
Alvaro	Harlow
Meaghan	Otero
Rosann	Nance
Corrine	Jacques
Sid	Clancy
Melani	Calderon
Darline	Meek
Leia	Lujan
Cameron	Hayward
Larraine	Ng
Mitzi	Gresham
Jesenia	Burch
Moshe	Waite
Natividad
Romaine	Rife
Larae	Schroeder
Michelina	True
Yukiko	Calabrese
Carmina	Jean
Loida
Hisako	Pulido
Reginia	Cho
Janiece	Roush
Wanetta	Brinson
Eveline	Stern
Janean	Costello
Karri	Beam
Deann
Cory	Bumgarner
Coral	Mark
Efrain	Gracia
Britany	Tolliver
Vernie	Woo
Idella
Kimberlie	Rosenbaum
Jaquelyn	Hatchett
Elicia	Troy
Wendie	Marcotte
Clement	Batts
Hedwig	Lemus
Aura	Fonseca
Jestine	Pond
Micah	Lam
Kylie
Mee	Linares
Corine	Sheldon
Na	Blackburn
Melony	Kohler
Tora	Nicholas
Corie	Hong
Enoch	Altman
Janetta	Conti
Brigette
Efren	Barron
Catalina	Chang
Jani	Tribble
Johnny	Fuqua
Fay	Cavazos
Lynelle	Stclair
Mireya	Mccrary
Ashlyn	Cowley
Meta	Gardiner
Giovanni	Pence
Ferdinand	Mccracken
Florencia	Mcdonough
Sondra	Beaulieu
Omer	Marin
Cornelia	Windham
Kenyetta	Boston
Douglass	Ingle
Cleora	Damon
Chau	Sloan
Ophelia	Schiller
Ariel	Bartlett
Jerilyn	Messer
Merlyn	Furr
Beckie	Stout
Tomasa	Harding
Latisha	Rosenberg
Aimee	Foy
Jerrod	Franco
Mallie
Celina	Rosen
Meghann	Beyer
Margarite	Sigler
Gracia	Hendrick
Inger	Tennant
Hermine	Stine
Juliann	Duran
Jacqualine
Rocky	Manson
Yi	Guillen
Slyvia	Behrens
Margorie	Bird
Delmer	Mccreary
Jerold	Overstreet
Shelton	Laird
Sau	Handy
Tamesha	Yarbrough
Camie	Brogan
Kiesha	Parrott
Shenita	Randolph
Pearly	Arredondo
Antwan	Callahan
Arleen
Edwardo	Overby
Marybelle
Lanora	Bartley
Shirleen	Graff
Nakia	August
Liliana	Farrar
Shin	Choi
Jannet	Maynard
Edison	Boothe
Crissy	Stamper
Ivonne	Forrester
Corrinne	Wakefield
Alexander	Kahn
Darell	Alves
Janene	Mccall
Helena	Spring
Alpha
Scarlet
Bertie	Withers
Carmelina	Nixon
Maricruz	Longoria
Elmira	Tracy
Danna
Kieth
Yetta	Angel
Pa	Benton
Erinn	Beltran
Syble	Rivers
Marx	Monk
Antonio	Guinn
Kaci	Flynn
Terese	Giordano
Logan	Burge
Lien
Savannah
Jeannine	Soria
Leandro	Amaya
Melonie	Arthur
Porfirio	Brill
Kizzie
Gabriel	Fenton
Nidia	Chism
Annabelle
Shaquita	Oneill
Janelle	Lim
Trish	Cowan
Sherryl	Ginn
Yang	Layman
Pura
Norah	Cooney
Ethelene	Ornelas
Lacy	Godwin
Dani
Leif	Suarez
Lennie	Fisk
Desirae	Merrick
Asley
Nadia	Levine
Alesha	Nesmith
Ezekiel
Shona	Mcduffie
Edgardo	Forte
Bernie	Keane
Luisa	Creighton
Josefine	Sikes
Dino	Trahan
Audrea	Brito
Augustina	Huskey
Shanita	Folse
Deeanna	Moser
Hee	Crouch
Cleta	Moya
James	Montes
Andra	Carswell
Myong	Zepeda
Mirna	Banda
Stefan	Blum
Daron	Cooks
Esta	Gregg
Lavina	Gauthier
Rosalia	Carden
Hanh	Funderburk
Kymberly	Burchfield
Myrtice	Cote
Anjelica	Held
Jacque	Paradis
Josphine	Trout
Kiyoko	Weed
Augustine	Simpkins
Lonnie	Ratliff
Angelique	Pappas
Karren	Dabney
Nicolle	Holman
Mickey
Trinidad	Mireles
Tifany	Titus
Etha	Garland
Aracelis	Cathey
Aurelio	Peyton
Julietta	Duckworth
Youlanda	Becnel
Hermila	Heflin
Cherry	Kurtz
Cindie	Cottrell
Hilary	Bentley
Joi
Gene	Higgs
Abram	Prewitt
Jon
Conception
Daine	Sage
Missy	Cromer
Dara
Hye	Mooney
Malia	Teel
Marylou	Whitt
Joye	Stoddard
Queenie	Strong
Kristofer	Jude
Adan	Mcewen
Chiquita	Whitfield
Mariano	Paquette
Francene	Faulkner
Pamala	Bourne
Sigrid	Arreola
Lauretta	Banuelos
Malka	Ha
Marisol	Faison
Hyo	Newell
Hulda	Battle
Kendrick	Fairbanks
Noma	Blount
Alla	Kiser
Kathlyn	Ricketts
Matthew	Cockrell
Stefanie	Mclendon
Coletta	Durr
Ahmad	Pereira
Brendon	Draper
Penni	Osorio
Nelly	Carmona
Chanda	Addison
Irena	Kramer
Jerrold	Velazquez
An	Bonilla
Caren	Savoy
Kimberley	Flanders
Hortense	Duckett
Randi	Mcgowan
Long	Grubb
Alina	Fraley
Dorie	Moffitt
Basilia	Coon
Shawnta	Hammonds
Charisse	Landis
Emelda	Lemmon
Luise	Medlock
Laureen	Schott
Marcene	Grenier
Monty	Robins
Winnifred	Michaud
Gerry	Dudley
Carie	Chaney
Millard	Leroy
Nicki	Weis
Lucinda	Matney
Many	Renner
Deeann	Close
Britteny	Booth
Sibyl	Falk
Terra	Jaeger
Tajuana	Mattson
Rigoberto	Demarco
Maryln	Penny
Joelle	Manuel
Alesia
Junior	Rayford
Yesenia
Shawnee	Hough
Margit	Quiroz
Vannessa	Fairley
Alline	Laporte
Jazmine	Desantis
Cleopatra	Kaiser
Tawana	Hamm
Branden	Sauer
Keira	Soares
Lachelle	Wheatley
Viki	Buckner
Tyrell	Benitez
Somer	Arnett
Brain	Mccray
Linn
Trang	Copley
Lisette	Ybarra
Maryland
Lisabeth	Gentry
Krysten	Delarosa
Dedra	Burk
Fern	Kenny
Mui	Donovan
Ela	Hailey
January	Carbajal
Britni	Lind
Chung	Queen
Celesta	Ly
Emil	Acevedo
Debrah	Esparza
Kristeen	Liles
Elane
Lovie	Ladner
Lianne	Ayala
Katharine	Mcgregor
Ka	Loy
Terina	Ness
Yoshie
Wesley	Tam
Karey	Richey
Ira	Caron
Keli	Cronin
Ellan	Person
Lashawna	Cabral
Marci	Eckert
Maxie	Armenta
Hyun	Kinney
Tanja	Earley
Nicholle
Elanor	Dennison
Gema	Levesque
Brinda	Palma
Antionette	Alba
Monserrate	Hein
Wilda	Streeter
Cruz	Isaacs
Stephania	Bussey
Nestor
Ardelle	Roberge
Art	Wallen
Bella	Raines
Shaunda	Harden
Shirely	Guess
Malena	Couture
Arline	Magana
Sherrell	Serna
Evan
Teisha
Lawanda	Alicea
Keneth	Knutson
Roselee	Scarborough
Jefferey	Evers
Bea	Janssen
Breana
Kyra	Murry
Keturah	Ring
Leonor	Teeter
Laverna
Refugio	Large
Amira	Koch
Peggie	Kane
Cristie	Rinaldi
Erline	Antonio
Inocencia	Becerra
Burton	Marchand
Pauletta	Thacker
Otelia	Jameson
Shavonda	John
Charlesetta	Henson
Kandy	Meade
Moira	Wolford
Albert	Lopes
Lane	Atchison
Toya	Somers
Elliott	Guevara
Rivka	Braun
Carisa	Saucier
Alisa	Melendez
Iva	Lumpkin
Renato	Gough
Joleen	Hahn
Chang
Lupe	Contreras
Sunny	Wooten
Belva	Echols
Jess	Mott
Garnett	Shah
Lourie	Calvin
Tennille	Oneil
Yael	Wooden
Kittie	Cintron
Joie	Kirby
Shaun
Janeth	Gatlin
Stormy
Sandy
Eugene	Woody
Harold	Smithson
Cheree	Barnette
Otilia	Heaton
Aida	Dominguez
Tuyet	Kinard
Katy	Dion
Myriam	Crabtree
Grazyna	Travers
Evelia	Lacey
Corrina	Yanez
Sina	Hatch
Lahoma	Domingo
Sammie
Avelina	Stuart
Aretha	Butterfield
Joellen	Loera
Roy	Randall
Maria	Barbour
Tameika	Nall
Catarina	Baer
Milly	Lara
Alphonse	Cerda
Agnus	Goddard
Marlana
Norberto	Shearer
Tiffaney	Kessler
Lona	Solano
George	Cooley
Glennie	Council
Rozanne	Mercado
Cherise	Ault
Tyra	Houle
Deonna	Valadez
Clare	Branham
Lorita	Phan
Doretha	Hildebrand
Cordelia	Rowan
Dayna	Smalley
Chrystal	Guy
Shaunna
Alec	Mcdonnell
Adaline	Burkett
Antoine	Roach
Joey	Sipes
Miesha	Lytle
Jeffry	Loveless
Celine	Masters
Abigail	Goebel
Lelia	Barrios
Mollie	Morrill
Stephaine	Keyes
Krystyna	Spears
Margaretta	Grady
Patricia	Richard
Marva	Lafferty
Dannie	Carney
Leilani
Galen	Talbot
Coy	Peek
Barbar	Peltier
Wilford	Hilton
Peg	Samson
Carletta	Hay
Wynell	Sun
Maximina	Heller
Karie	Mangum
Sanora	Isom
Merna	Falls
Madie	Hook
Darleen	Wylie
Willia	Whitaker
Annis	Trammell
Pinkie	Whitehurst
Trey	Mckinnon
Elna	Ricker
Kirstin	Havens
Reuben
Adena	Ngo
Danelle	Vail
Anastacia	Mora
Tommy	Payton
Dian	Cervantes
Divina	Gamboa
Shira	Stjohn
Burma	Burt
Cherrie	Oaks
Temple	Dees
Vernia	Gunter
Fatima	Gallant
Michiko	Sides
Wan	Coulter
Chris
Sharell	Pogue
Nathanael	Ivy
Cecile	Cordell
Tad	Frias
Rosamond	Rinehart
Valentin	Yi
Albertine	Redd
Emmie	Benefield
Autumn	Mcmanus
Phebe	Dozier
Bonny	Demers
Laticia	Ainsworth
Merle	Muse
Ming	Edmonds
Toby	Hawthorne
Terica	Pak
Pierre	Zaragoza
Sherie	Rauch
Estrella	Leung
Dale	Kee
Kelley	Bond
Mika	Humes
Alida
Kyla	Sears
Chery	Kemp
Numbers	Peak
Delta	Irvine
Buddy	Livingston
Esperanza	Jorgensen
Valentine	Boland
Shayla	Huntington
Rossana	Pryor
Ariel	Stiltner
Soon	Coe
Merrill	Seitz
Zulma	Broadway
Alden	Fite
Yahaira
Felisha
Xochitl	Bagwell
Elfreda	Fairchild
Belle	Thao
Aileen	Holiday
Mira	Mcmillan
Fawn	Hutson
Akiko	Hirsch
Thea	Turley
Isabelle	Whittaker
Etta	Toler
Naoma	Seaton
Armida	Stallworth
Carita	Mcclelland
Marcie	Helton
Maddie	Oshea
Isaura	Beckham
Manie	Scroggins
Doloris	Masterson
Arielle	Ledbetter
Helene	Will
Celsa	Belcher
Janeen	Vanmeter
August	Ellison
Daren	Hartman
Dori	Keeton
Rusty	Clemons
Lakeisha	Beckett
Rickie	Souza
Gita	Rossi
Harriette	Starks
Cami	Brinkley
Dung	Morey
Louis	Cline
Tessie	Lavigne
Kareen	Barksdale
Nikki	Turnbull
Leigh	Bunting
Georgene	Coppola
Reyna	Mcmahon
Valrie
Arianne	Pitt
Grover	Falcon
Precious	Carnahan
Cara	Spearman
Luanna	Donnell
Eli	Toth
Mariana
Ignacia	Lefebvre
Roselle	Gallo
Kristel	Gonsalves
Stefania	Pease
Minh	Hatcher
Lauren	Ernst
Richard	Dalton
Annika	Shepherd
Hilma	Rico
Georgie
Jae	Knox
Eliz	Treadwell
Laurel	Parent
Piper	Tomlinson
Bronwyn	Mahaffey
Robt	Wasson
Santos	Irby
Curt	Conyers
Bok	Lantz
Marhta	Schuster
Patience	Silvers
Genevive	Worthy
Adelaide	Hitchcock
Myrl	Mauldin
Johanne	Burrow
Vilma	Kirkpatrick
Rosario	Criswell
Zackary	Lawton
Lemuel	Biddle
Nanci	Patino
Lyndsay	Aiken
Jeneva	Ocasio
Alvera	Lebron
Gay	Leal
Leena	Harlan
Janae	Shank
Ulysses	Schreiber
Rosio	Alonzo
Edmundo	Sallee
Cyndi	Hurley
Damian	Martz
Steven	Henning
Marti	Babb
Vertie	Palumbo
Lily	Foote
Lashell	Battles
Mervin	Pinkston
Rashida
Gertie	Hanley
Elliot
Charla	Dooley
Mario
Billie	Craddock
Ashton	Jessup
Dewayne	Perrin
Mozell	Kowalski
Marnie	Rigby
Delisa	Shull
Barney	Mauro
Alona	Pickens
Wally	Wiles
Rosalyn
Madge	Burrows
Tawanda	Slattery
Ali	Spear
Lurline	Lipscomb
Bari	Freitas
Evangelina	Forsythe
Hyman
Jacquelin	Portillo
Suanne	Woodard
Carly	Frasier
Sage	Ashcraft
Rozella	Bolling
Britt	Thorpe
Patrica	Medlin
Fransisca	Steadman
Quinn	Devore
Renata	Coles
Angelena	Worden
Agripina
Kris	Hancock
Arlen	Keen
Georgina	Medeiros
Sebastian	Crosby
Carman
Wei	Markley
Clemencia	Parkinson
Gino	Vu
Shandi	Proffitt
Edra	Halcomb
Delois	Buck
Loma	Larue
Gaylord	Bunnell
Julianna	Begay
Shantay	Kroll
Yasmine	Holm
Ranee	Stiles
Kathi	Thames
Mickie	Post
Denita	Lucero
Kevin	Frierson
Young	Higginbotham
Sheena	Colvin
Adriana	Valdes
Theron	Hartley
Vonda
Tashia	Feliciano
Dominica	Coons
Joan	Labbe
Eugenio	Loving
Rena	Stanford
Maybelle	Currie
Hildegarde	Gallagher
Quintin	Hager
Catheryn	Prater
Jude
Dayle	Mcmillian
Adriene	Jewell
Robena	Smyth
Lizzie	Sinclair
Jamaal	Avila
Rosalinda	Street
Selma	Moen
Austin	Mccullough
Marcellus	Sutherland
Willy	Simms
Adolfo	Busch
Clora	Bolen
Demetrius	Laws
Maida	Neumann
Lovetta	Delacruz
Danita	Griffis
Allena	Slade
Joselyn	Crockett
Sterling	Clinton
Marlo	Salisbury
Gregorio	Mesa
Honey	Numbers
Maryanne	Borden
Basil	Gilson
Marita	Halsey
Carolann	Bickford
Lilia	Conway
Zina	Skelton
Rayna	Calvert
Jewel	Worrell
Shanna	Barbosa
Violette	Fernandes
Danuta	Hinds
Izetta
Casandra	Mccune
Lai	Hurd
Raylene	Woodcock
Gary	Wesley
Wilburn	Main
Mandi	Stamps
Benton	Mchugh
Shu	House
Asuncion	Mackie
Trista	Lancaster
Linnea	Blakely
Zandra	Hogg
Kattie	Forbes
Amada	Clement
Raleigh
Rosalva
Cristine	Guidry
Sharilyn	Mendenhall
Digna	Waddell
Briana	Sprouse
Freida	Rees
Teresita	Vickers
Barbera
Latashia	Mclemore
Juan	Neill
Camellia	Shumaker
Caprice	Bethea
Dede	Lanier
Colette	Yu
Trudi	Cushman
Thu	Sylvester
Arron	Fritz
Keitha	Suggs
Tisa
Nell	Temple
Murray	Halverson
Jonah	Crider
Cher	Ames
Donnell	Freedman
Nga	Forrest
Lisandra	Gatewood
Shella	Beasley
Wenona	Snipes
Louanne	Roman
Shyla	Wilkes
Evie	Lindley
Elouise	Freed
Keiko	Wall
Shanell	Rupp
Marquis	Hedges
Johnie	Wilt
Sylvie	Kilgore
Sharla	Bagley
Vasiliki	Martino
Keila
Jodie	Hoyt
Lanell
Tempie	Horne
Adell	Olivarez
Clorinda	Olmstead
Crista	Rankin
Assunta	Malley
Joaquina
Zella	Meador
Mitchell	German
Avery	Andrade
Roscoe	Buss
Yee	Ruff
Charis	Betts
Julianne	Ashton
Salley	Gladney
Yuki	Harbin
Li	Chavarria
Emerald
Camelia
Kenyatta	Dube
Kati	Mayer
Marge	Ackerman
Aide	Eaves
Bud	Roland
Tillie
Meggan
Roseann	Berlin
Toccara	Qualls
Sheree	Florence
Marianela	Pitre
Carylon	Farr
Silvana	Sumner
Leonore	Coats
Maudie	Kellum
Franchesca	Marion
Felton
Diego	Derr
Madison	Mims
Elisha	Wilde
Tam	Gann
Ronald	Fischer
Kathrin	Sapp
Sung	Quezada
Antonetta	Lai
Afton	Hyman
Ona	Hammons
Lewis	Mckenney
Lashandra	Otis
Juli
Virgil	Lacroix
Geraldo	Crooks
Krysta	Linton
Annemarie	Hickson
Bree	Mccann
Bao	Cheung
Tenisha	Cope
Marleen	Heffner
Romana
Delmar	Almeida
Darlena	Whitson
Dagny	Stubbs
Ellsworth	Whyte
Ling	Maurer
Rowena	Rivas
Felice	London
Detra	Turney
Charlsie
Russ	Bowie
Shakia	Cates
Herminia	Leavitt
Tierra	Downing
Torie	Mcintyre
Margrett
Samira	Joe
Noble	Leeper
Sharika	Frye
Dennis	Meacham
Patria	Hoy
Fausto	Pollard
Albertha	Pauley
Oren	Estep
Charity	Keaton
Jamison	Looney
Rolf	Crandall
Kandace	Crump
Reba	Montoya
Sal	Bollinger
Glayds	Elam
Lavonia	Wagoner
Rosalina
Rosaria	Basham
Cortney	Packard
Stefani	Drew
Jeraldine	Joyner
Louetta	Messenger
Alvina	Dickerson
Willow	Hickey
Karry	Navarrete
Georgetta	Yost
Jolanda	Jay
Steffanie	Burnside
Karoline	Bertrand
Joetta	Mortensen
Clarissa	Purdy
Eddy	Naylor
Antonette	Nutt
Sherrill
Christin	Brandt
Jessia	Valentin
Alex	Barth
Kathie
Olene	Parra
Irmgard	Pulley
Venessa
Jewel	Han
Onita	Wisniewski
Lezlie	Goetz
Aurea	Koehler
Jacquelyne
Lorelei	Apodaca
Winfred	Garris
Berta	Ratcliff
Lester	Wayne
Isabella	Fish
Keshia	Kern
Trula	Thurman
Genna	Marx
Eloy	Keel
Letitia
Boris	Seeley
Mistie	Farris
King	Healey
Loriann
Henry	Tinsley
Luba	Mcneill
Lea	Deloach
Pandora	Mast
Keeley	Kitchens
Nigel	Bull
Silas	Mullis
Willene	English
Jeanene	Hennessey
Sindy	Ma
Miss	Carmichael
Major	Myles
Vivien	Rash
Valery	Yamamoto
Moriah
Stevie	Fielder
Tisha	Teague
Benito	Broughton
Amal	Doss
Kenia	Boren
Deloras	Hankins
Annita	Duffy
Janessa	Mares
Rebbeca	Berg
Charlena	Southard
Valarie	Swisher
Adolph	Sell
Lindy	Bello
Kym	Pool
Gianna	Segura
Yadira	Ennis
Noreen	Mccormack
Judson	Vickery
Mitch
Octavia	Trevino
Nanette	Haggerty
Nakisha	Mcallister
Mariah	Kent
Stephenie	Stratton
Kaye	Foreman
Astrid	Parr
Rosanne	Kirk
Cecila	Decker
Sirena
Sueann	Culbertson
Olen	Brunson
Frederic	Broyles
Alverta	Shields
Anissa	Littlefield
Haley	Tillery
Tamika	Mcqueen
Cathey	Beach
My	Spangler
Arlette	Benavidez
Lou	Moye
Nia	Canady
Alica	Rendon
Joannie	Bradshaw
Gemma	Ashworth
Shanda	Reagan
Angla	Thatcher
Meridith	Wyatt
Katelynn	Story
Marlen	Castellanos
Bart	Stahl
Eldridge	Bermudez
Allyson	Meredith
Lorean	Ahern
Jade	Bullock
Kali	Milliken
Jacinta	Thornburg
Raymon	Swafford
Brianne	Paz
Alva	Rangel
Meri	Cosgrove
Isadora	Donald
Bee	Bassett
Lawana	Blanchard
Shanti	Dollar
Elroy	Dumas
Starr	David
Yasuko	Quintanilla
Stasia	Alonso
Adina	Salinas
Florene	Jorgenson
Dannielle	Cordero
Lindsy	Keefer
Delma
Thanh	Mckay
Louvenia	Bittner
Lorri	Beatty
Julio	Littlejohn
Beula	Hardwick
Ji
Toshia	Scholl
Bertram	Hendrix
Jazmin	Zeigler
Germaine	Pyle
Lane	Way
Paris	Cody
Jama	Passmore
Carroll	Hudgens
Page	Olsen
Stephen	Molina
Alfreda
Cythia	Marrero
Lesa	Vazquez
Debroah	Bogan
Dallas	Shelby
Risa	Waterman
Nida	Seibert
Suzi	Sharkey
Annamarie	Christianson
Tonie	Storey
Edwina	Adcock
Jessika	Bruno
Kacey	Renteria
Brittani	Duff
Melynda	Tripp
Felipa	Hanlon
Denice	Minor
Marietta	Shipley
Mina	Sheehan
Dennise	Fortner
Troy	Dillard
Newton	Hiatt
Jame	Sharpe
Rodrigo	Mata
Iliana	Braden
Cyril	Julian
Sabine	Vance
Kasha	Harms
Cassaundra	Coates
Karma	Swain
Neoma	Gamez
Lu
Vernetta	Mccaffrey
Ma
Marjory
Junita	Grimm
Izola	Grace
Floria
Ammie
Jen	Edward
Rachele
Sona	Kimball
Sumiko
Zola	Wirth
Raven	Robison
Tommye	Thrash
Marybeth	Read
Isaias	Lombardi
Viviana	Herbert
Janyce	Hoffmann
Sherley	Krieger
Barbra	Sierra
Shane	Bearden
Amalia
Fredric	Howe
Kecia	Lundy
Abdul
Charmain	Atherton
Hermina	Still
France
Phylicia
Kayleigh
Eugena	Frazer
Hosea
Lavelle	Stowe
Maude
Christi	Fiore
Kena	Mahoney
Lynsey	Mcalister
Lakendra	Whitehead
Krystle	Elias
Adam	Bowling
Noel	Stock
Bret	Leake
Len
Jocelyn	Olvera
Lincoln	Keegan
Leanora	Duong
Kelsie	Staggs
Vernon	Rosa
Cecille	Kopp
Norene	Dow
Vada	Fournier
Augustine	Grove
Charlott	Ziegler
Kendall	Bliss
Ericka
Sharita	Brannon
Ouida	Greenberg
Nancie	Leggett
Aurora
Laila	Cromwell
Eliseo	Oleary
Krishna	Childers
Damien	Spaulding
Shani	Eubanks
Therese	Wilmoth
Lavonna	Squires
Joe	Posey
Veda	Schuler
Lanette	Croft
Eartha	Ulrich
Noelia	Alley
Alix	Archuleta
Jonell	Gruber
Nydia
Erich	Bach
Stephine	Hwang
Nicolasa	Beaudoin
Jamila
Fran
Tamekia	Barney
Karolyn	Judge
Harrison	Clay
Lenore	Bobbitt
Maryellen	Hope
Marlena	Hardison
Raymond	Novak
Kellye	Hinton
Vella	Garmon
Colene	Rollins
Nikole	Gabriel
Saran
Aaron
Cathi	Lindgren
Lindsey	Toro
Zachery	Mcgraw
Eufemia	Ebert
Birgit	Raynor
Maryrose	Ison
Kirsten
Elton	Fife
Chia	Villalobos
Margart	Breeden
Krystin	Ferreira
Clementine	Melvin
Cheyenne	Bartels
Tegan
Venetta	Guest
Pasty	Quinones
Tien	Sorenson
Thanh	Seidel
Melodee	Coble
Tobi	Stump
Zachariah
Concetta	Catron
Blanch	Hobson
Verla	Mercier
Richie	Fry
Kenisha	Crouse
Kassie	Gass
Shala	Mclain
Maranda
Lisha	Alderman
Dessie	Gates
Cherly	Emerson
Aubrey	Browder
Anton	Riggs
Dalene
Claud	Radford
Mammie
Alycia	Nunes
Cristin	Negron
Vivienne	Shin
Reid	Blackmon
Cecily	Clevenger
Danika	Derrick
Brandon	Rainey
Cleo	Browne
Priscila	Larry
Kindra	Lowman
Odis	Correia
Pansy	Greathouse
Kazuko	Carver
Arnulfo	Sanderson
Carry	Ripley
Socorro	Bruns
Ronna	Morehead
Jerry
Buffy	Reddick
Hermelinda	Donahue
Yoshiko	Fennell
Darcel	Easley
Veronique	Wyman
Celestine	Herron
Han	Minnick
Shela
Adrianna	Shifflett
Garret	Ashmore
Nita	Loper
Stanford	Fultz
Gerald	Barden
Mckinley
Ayana	Winn
Chun	Speer
Juliette	Kunz
Hoa	Smalls
Bernie	Brunner
Shawana	Tejeda
Perry	Hillman
Georgeann	Robson
Hilton
Devin	Bellamy
Gregory	Monson
Luetta	Mcclendon
Kellee	Starling
Casimira	Worley
Rosenda	Logue
Lilliam	Borrego
Erwin	Belton
Benedict	Newberry
Karol	Kline
Valencia	Cutler
Shantae	Villegas
Khalilah	Silverman
Sherell	Haskell
Latonya	Brockman
Kemberly	Sample
Oliva	Bandy
Lavinia	Marquez
Luanne	Sauls
Aldo	Lightfoot
Nila	Lyles
Son	Dockery
Gwenn	Noyes
Corrin	Loftin
Idalia	Pulliam
Trinidad	Osullivan
Arletta	Carman
Margery	Najera
Tammera	Braswell
Temika
Towanda	Barela
Freeman	Sizemore
Teofila	Lapointe
Jules	Kuhn
Graig	Cowles
Minerva	Kellogg
So	Denton
Leoma	Dyson
Demetria	Nesbitt
Nannette	Schwab
Lacie	Britton
Albertina	Keys
Dorathy
Tiana	Spinks
Scottie	Laflamme
Andree	Melton
Collette	Wray
Elly	Easterling
Melvina	Colley
Fidel	Hamrick
Leonel	Dolan
Reatha	Mcvay
Tommie	Mccue
Bong	Saxon
Reynaldo	Pepper
Bernetta	Mcconnell
Daisey	Langdon
Kallie	Dubose
Asia	Ohara
Kathey	Richmond
Blossom	Mclaurin
Vida	Cobbs
Landon	Withrow
Serita	Bonner
Dulcie	Lomax
Kimberli	Lima
Shanika
Lilliana	Rojas
Tereasa	Huey
Altagracia	Kerr
Evalyn	Dowd
Waneta	Place
Myrna	Shumate
Zonia	Slaton
Magdalene	Trent
Abbie	Click
Linwood	Sutter
Hallie	Priest
Tyron	Minter
Marine	Mayes
Helga	Camarillo
Freddie	Alcala
Delphia	Wendt
Pilar	Picard
Isis	Fuentes
Cody	Mabry
Leatha	Guyton
Georgiann	Denson
Lucretia	Castaneda
Ardella
Kyle
Duncan	Koonce
Lorette	Thayer
Cammy	Felix
Royce
Johana	Leone
Bernardo	Steed
Azalee	Albrecht
Hank	Sander
Macy	Block
Lani	Hyde
Branda	Gandy
Noe	Noe
Ellis	Leahy
Ahmed	Geer
Samara	York
Delilah	Crowley
Vita	Abell
Tinisha	Coronado
Rich	Edgar
Ellie	Hawes
Ezequiel	Mccauley
Reed	Hendrickson
Yong	Hulsey
Van	Rousseau
Glenna	Vincent
Karyn	Hutchins
Tamica	Mckinley
Mavis	Brant
Tana	Samuel
Carter	Avery
Jeanelle	Settle
Tamar	Barrera
Lou	Sands
Francisco	Mcknight
Nola	Nickerson
Lourdes	Ritchie
Sharda
Ashely
Sallie	Calloway
Starla	Ali
Frankie	Biggs
Carrol	Spence
Gaylene	Voss
Jenine	Haller
Fanny
Samual	Pinto
Brigitte	Bauman
Alethia	Noble
Sherron	Harder
Aiko	Barone
Glynis	Vogel
Hillary	Reedy
Anette	Blaine
Genevie	Homer
Shellie	Workman
Jennine	Ivory
Jesus	Stoner
Hans	Vann
Margarette	Getz
Mendy	Sotelo
Claretha	Victor
Ronni	Petty
Setsuko	Judd
Shanice	Keener
Jong	Tisdale
Vania	Bordelon
Tarah	Crutchfield
Mckenzie	Coffman
Marvis	Bunn
Lorinda	Aguiar
Fonda	Harwood
Herb	Blaylock
Marinda	Pino
Jessi	Mcnutt
Carmela	Hornsby
Orval	Fontaine
Dorthey	Christopher
Gail	Allman
Muoi	Brandenburg
Brigid
Teresia	Dowell
Elidia	Dodd
Rickie	Maki
Kelsi	Rooney
Lyla	Okeefe
Eda	Romeo
Shalon	Lessard
Chantelle
Lenny	Ashe
Fidelia	Morin
Nenita	Trejo
Valeri	Hynes
Pamula	Sousa
Bennie	Nugent
Dione	Dickson
Matilda	Orr
Gale	Roche
Randell	Dutton
Gerry
Elisabeth	Marr
Teena
Mitsue
Ellena	Hoyle
Carmon	Strange
Christa	Sturgeon
Aurelia	Covert
Gertrud
Sunday	Mcrae
Erasmo	Lachance
Candra	Littleton
Latasha	Drummond
Hae	Ojeda
Stephnie
Eustolia	Inman
Williemae	Ontiveros
Madonna	Frick
Wilhemina	Tirado
Luciano	Archibald
Sanford	Escobedo
Loren	Burr
Mandie	Burroughs
Demarcus	Sherrod
Jaunita	Purnell
Sandie	Crum
Avery	Ramey
Vernice	Carbone
Jerica	Cave
Sonny	Schulze
Vinnie
Kimber	Dunne
Tameka	Tilton
Jacki	Lemon
Sacha	Billings
Anabel	Seward
Brook	Self
Ilse	Crocker
Porsche	Lerma
Eldora	Strother
Armandina	Gossett
Jaclyn	Ventura
Danyell	Shaver
Donn	Faulk
Dreama	Delgadillo
Janina	Silvia
Gillian	Fontenot
Ying
Leonora	Mullin
Dia	Jack
Sheron	Prescott
Wava	Barclay
Verdie	Ricks
Norine	Merriman
Warner	Archie
Milagro	Lehmann
Annelle	Denney
Chuck	Hagen
Takisha	Louis
Christiana	Lassiter
Dion	Dodson
Kenda	Nickel
Sana	Hidalgo
Burt	Mckenna
Karleen
Tianna	Bloom
Sanjuanita	Holguin
Twila	Granados
Raphael	Sager
Christal	Chase
Lucien
Teressa	Mccord
Loris
Cristy	Plunkett
Ashlee	Truitt
Kum	Kraus
Mitzie	Lindquist
Chaya	Sweat
Terresa	Koenig
Enid	Darby
Tawny	Baumann
Robbyn
Eleonore	Florez
Kamilah	Sparrow
Sparkle	Baxley
Ricki	Haggard
Olimpia	High
Carolee	Elmore
Michell	Badger
Maryetta	Walling
Shakira	Rosario
Andera
Shanae	Orta
Josette	Mcdowell
Gennie	Hubert
Shaniqua	Reeder
Carlotta	Hawks
Daina	Mcneely
Mariela	Frizzell
Cinthia	Bruner
Lissette	Clements
Klara	Hinson
Mari	Hargrove
Glinda	Allred
Lael	Song
Ok	Carrington
Carlie	Healy
Palma	Parrish
Dudley	Cheek
Abe	Heck
Janee	Lyle
Keva	Janes
Virgie	Gable
Maren	Calkins
Penelope	Montero
Roselia	Medrano
Tiffiny	Mcswain
Norman	Peeler
Prudence	Bean
Patrick	Thibodeau
Reita	Shephard
Gilberte	Lavoie
Ettie	Hopson
Almeta	Oswald
Drucilla	Grigsby
Retha	Shirley
Fae	Cleary
Corina	Helm
Kiana	Finn
Tanika	Maguire
Corene	Reynoso
Mirella
Mariel	Espino
Jung	Wick
Clarita	Hess
Lakisha	Mahan
Saturnina	Scherer
Kimberlee	Ladd
Felisa	Lyon
Armand	Woodward
Chelsie	Benedict
Scottie	Rigsby
Angelika	Mattison
Jenifer	Bernal
Zack	Jernigan
Lisbeth	Sisk
Marline	Galvez
Corinna	Allard
Marceline	Valenti
Maryjane	Steel
Daphne	Crayton
Loralee
Jacquelynn	Haugen
Jamee	Steinberg
Eric	Polk
Cassi	Weston
Terrell	Durand
Nisha	Kemper
Parthenia	Dempsey
Giuseppe	Adame
Otha	Rowley
Lucile	Redding
Takako
Adelaida	Hoskins
Mabelle	Quinonez
Vennie	Bryson
Mei
Tona	Wimberly
Miki	Knowlton
Katheleen	Outlaw
Marchelle	Grooms
Rebbecca	Law
Sybil	Weddle
Randee	Mabe
Tessa	Gage
Rudolf	Nelms
Jacqulyn	Boucher
Domenica	Whitlock
Reda	Tiller
Maragaret	Beavers
Berneice
Caroll	Roney
Rueben	Craven
Fredia	Huffman
Yuri	Hardesty
Clementina	Lemke
Franklyn	Dang
Alba
Renaldo	Mcmahan
Sol	Macias
Coretta
Latrina	Escalante
Chin	Ely
Krissy	Vue
Bobette	Tierney
Ruthe	Horn
Elmo	Vernon
Anibal	Galindo
Devona	Swank
Refugia
Cira	Sommer
Renetta	Morley
Graham	Buffington
Nohemi	Flagg
Tequila	Hacker
Raina	Butts
Annett	Head
Celeste	Stackhouse
Sherlene	Craft
Erlinda	Dangelo
Kacy	Raley
Stacey	Pineda
Jacques	Franks
Lyndon	Bautista
Ngoc	Linkous
Lucie
Booker	Bivins
Cherelle	Fay
Bobbi	Espinoza
Rey	Ayers
Alda
Liza	Keeney
Jacqui	Salcedo
Dakota	Cantwell
Bebe	Etheridge
Roxann	Mcdougal
Blondell	Barnhill
Victorina	Haskins
Cherlyn	Babin
Belkis	Holbrook
Dan	Crain
Stefany	Baca
Lesley	Madrigal
Min
Carmella	Eng
Livia	Urban
Eden	Trudeau
Juliet
Madlyn	Zimmer
Jack	Fortune
Dottie	Shannon
Dwana	Traylor
Nicolette	Harness
Isobel	Frantz
Cassie	Zhang
Michaela	Bohn
Elaina	Back
Ronda	Crespo
Roxane	Pape
Beaulah	Giroux
Sherrie	Hackney
Thomas
Isreal	Lynn
Delora	Chung
Gonzalo	Buckingham
Cinda	Sparkman
Maura	Schofield
Jacelyn	Skinner
Pamella	Caballero
Adalberto	Stephenson
Audry	Chadwick
Adrien	Holder
Treena	Moreau
Laine
Betsey	Talbert
Wendi	Pollock
Elvera	Metzger
Lavona
Cherri	Clarkson
Donnette	Patten
Karrie	Yoder
Tanisha	Vogt
Ching	Clifton
Beryl	Kinder
Shenna	Duval
Carson	Bohannon
Sofia	Shinn
Bryce	Brennan
Reina	Grayson
Zula	Carlisle
Earlie	Snell
Tari	Mcdaniels
Lala	Reyna
Jeanine	Currier
Ryan	Friedman
Latarsha	Nobles
Shirly	Ramsay
Francie	Elkins
Royal	Burleson
Kanisha	Clanton
Cletus	Cady
Zenia	Singh
Berry	Jett
Shae	Porterfield
Danette
Chanell	Whitley
Alia
Shameka	Tuggle
Kimbra	Wang
Latina
Dorethea	Berger
Laree	Crenshaw
Eleni	Partridge
Juliane	Hutton
Kaylee	Mccurdy
Temeka	Bills
Waylon	Bunch
Tandra	Blackman
Laurence	Russ
Vannesa
Magaly	Flemming
Verlene
Demetrius	Trujillo
Sharan	Lehman
Christen	Huerta
Christia	Keene
Margarett	Ferris
Chong	Moffett
Brittanie	Donnelly
Sharee	Wilhelm
Gavin	Cherry
Will	Gifford
Genny	Paris
Santo	Neville
Hyon
Alaine	Gillen
Dominique	Lake
Osvaldo	Stark
Tory	Vinson
Rema
Moises	Nunn
Genesis	Isaacson
Kanesha	Beaty
Kiara	Burney
Robbie
Son	Luce
Drusilla	Short
Gena
Trudy	Goble
Rolanda	Solomon
Suzanna	Sargent
Thora
Jannette	Crawley
Elida	Rea
Magdalena	Wharton
Ozell	Carnes
Chelsey	Nagy
Concha	Blanton
Leann	Corrigan
Randy	Dorris
Minda	Kenyon
Arnette	Bruton
Ollie	Jefferies
Ozella	Milam
Janna	Woodley
Casie	Wilder
Torri	Moll
Su	Zapata
Estefana	Roark
Tobias	Hopper
Hong	Wheaton
Nancee	Spellman
Kimberely	Peebles
Aja	Connor
Floretta	Earle
Evangeline	Caswell
Ava	Boykin
Alyson	Eagle
Mercedez	Taggart
Tamisha	Rafferty
Neda	Escobar
Faustina	Washburn
Minh	Tolbert
Lamont	Stepp
Crysta	Troutman
Horacio	Darnell
Milissa	Sowers
Magan	Wu
Vi	Galbraith
Bennett	Thorn
Caron	Wetzel
Lucila	Oden
Twyla	Valenzuela
Addie	Linville
Darcie	Ordonez
Aron	Burger
Garth	Dortch
Alleen	Barry
Shalonda	Pham
Katina	Grissom
Elinor	Westmoreland
Bonita	Sellers
Lyman	Berube
Gladis	Galvin
Alysha	Begley
Adella
Fermina
Breann	Cruse
Janette
Donnetta	Baugh
Micheal	Elder
Shirley	Fanning
Katlyn	Shaffer
Kimi	Alaniz
Martine	Dejesus
Hortensia	Douglass
Vernell	Elliot
Tera	Groves
Cedrick	Ezell
Bryanna	Augustine
Otha	Rosales
Columbus	Goldman
Siobhan	Farley
Rubie	Nowlin
Delfina	Noonan
Arlie	Daly
Almeda	Pride
Martina	Staten
Tiesha	Matos
Gayle	Bertram
Theo	Holliday
Tamala	Burris
Lavonne	Andre
Sierra	Kearns
Argelia	Totten
Mellisa	Hutchinson
Avis	Rau
Marvella	Clapp
Dinah	Artis
Mary	Roden
Lettie	Geary
Shawnda	Singer
Dawna	Walter
Alaina	Poulin
Leontine	Winter
Denae	Theriault
Noemi	Caruso
Melvin	Akin
Sherlyn	Cortes
Ronnie	Cochrane
Cherish	Barbee
Alta
Julene	Vetter
Joel	Dupree
Rosina	Roderick
Colton	Hatton
Karan	Denny
Simone	Proctor
Alane	Leary
Valorie	Miranda
Cassey	Amador
Magnolia	Hobbs
Samatha	Terrell
Trenton	Rosser
Numbers	Ligon
Ines	Oconnell
Paul	Mcpherson
Reena	Reinhart
Mahalia	Ostrander
Cristi	Marcus
Karly
Edythe	Pettit
Hollis	Jamison
Rosita	Stovall
Nella	Stein
Elfriede	Mohr
Fallon	Saldana
Tresa	Simons
Vickey	Faber
Kip	Mcneal
Breanna	Mcwhorter
Charlie
Lakiesha	Foust
Brandee	Dasilva
Dalila	Holcomb
Madelyn	Valentine
Arnetta
Latesha	Mattos
Reta
Emilia	Cade
Shawanda	Webber
Buck	Bedford
Johna	Mcinnis
Tish	Huang
Shantelle	Pickett
Rob	Strain
Darwin	Ferrell
Christena	Riddick
Angila	Culp
Dania	Link
Shaneka	Gunther
Carlene	Aquino
Idell	Vest
Nery	Kitchen
Kandis	Mattox
Harley	Harwell
Maisie	Small
Drew	Luther
Tawnya	Oh
Rosette	Levin
Oralia	Hamblin
Coralee	Wiggins
Soledad
Jame	Metzler
Corliss	Clemmons
Aurore	Winters
Zora	Galarza
Leonia	Bravo
Renae	Asher
Isa	Winston
Sena	Wicker
Jere	Henley
Noriko
Latia	Weatherly
Gabriella	Culver
Sabra
Cristal	Covey
Carma	Hyatt
Armanda	Coker
Isela	Hanes
Zetta	Causey
Imelda
Petronila	Legg
Lara	Lombardo
Chantel	Salas
Kerstin	Goad
Birdie	Waldron
Delpha	Corona
Pearle	Marcum
Rae	Lentz
Federico	Stack
Loraine	Andres
Ilene
Vanita	Crow
Keenan	Cuevas
Anderson	Reichert
Niesha	Ridenour
Kamala	Halstead
Vashti
Lore	Rutledge
Filiberto	Ham
Dorla	Cahill
Marcel	Baughman
Anneliese	Oconnor
Tamera	Groce
Arlinda	Brandon
Joshua	Stull
Lashawnda	Olivo
Maxwell	Aviles
Aracely	Barnard
Johnetta	Boggs
Kaila	Rapp
Vern	Koontz
Tonisha	Thurston
Lacy	Nadeau
Le	Petersen
Ute	Mcnabb
Shenika	Lovejoy
Jennefer	Nation
Amie	Gleason
Maragret	Bolt
Myles
Louisa	Byrnes
Carissa	Ponce
Chan	Bouchard
Angelic
Jeana	Uribe
Arie	Button
Katelin	Call
Raymonde
Darrick	Pace
Naida	Whitten
Yelena	Riddle
Ashley	Browning
Georgann
Dante	Helms
Leanna
Shantell	Israel
Micaela	Amos
Bernita	Berryman
Jenell	Pleasant
Emerson	Cornett
Morgan	Carlton
Contessa	Binder
Jed	Fortier
Gwenda	Karr
Merrill	Miner
Dollie	Mcfarlane
Asha	Blanco
Dorthy	Ochoa
Annamaria	Maxey
Jamey	Runyon
Monnie	Scales
Jackson	Smallwood
Shirlee
Caitlin	Hendricks
Lonna	Winslow
Mellissa	Nettles
Anja	Tong
Carmen	Blackwood
Johnathon	Hatfield
Fiona	Rasmussen
Cornell	Horner
Selene
Ramonita	Dodge
Reanna	Breaux
Huey	Giron
Simonne
Alisia	Lavender
Ryann	Irwin
Suzie	Poland
Laverne	Newsom
Dorsey	Mccain
Lawerence	Mcfadden
Candie	Slack
Kiley	Whitlow
Nova	Ho
Riley	Coombs
Annalisa	Dailey
Denny	Trimble
Robbie	Landrum
Fe	Atkinson
Darby	Batista
Stacee	Nolen
Keri	Meier
Melia	Shell
Malik	Tan
Marina
Leslee	Harkins
Ray	Pennell
Kenton	Spooner
Francoise	Mancuso
Jene	Goodrich
Faustino	Snead
Effie	Jarrett
Phyliss
Granville
Lashaunda	Fitts
Kermit	Tipton
Larisa	Gentile
Kendall	Francisco
Farrah
Dannette	Oreilly
Davina	Mcgill
Charmaine
Roxanna	Elizondo
Kala
Belen	Glass
Keena
Era	Shuler
Laquita	Boss
Tashina	Westbrook
Laurette	Hoff
Syreeta	Burrell
Lon	Dellinger
Harlan	Mull
Dane	Cupp
Tamra
Marylin	Rudolph
Robbi	Battaglia
Iona	Mcnally
Trinity	Bingham
Rosalind	Andersen
Brittni	Bergstrom
Treasa	Toliver
Carl	Heckman
Meg	Pfeifer
Jesica	Beckwith
Allen	Byars
Alecia	Maness
Dierdre	Caudill
Fleta	Kovach
Serena	Negrete
Katherin	Wooldridge
Barabara	Kaye
Mitsuko	Richter
Yun	Scarbrough
Hal	Catalano
Zaida	Hawley
Mila	Younger
Carolin	Poirier
Johnsie	Esquivel
Marquerite	Tyson
Raguel
Emmanuel	Beers
Heike	Norwood
Denny
Mechelle
Elayne	Dahl
Mathilde	Nava
Shonta	Kimbrough
Vanetta	Brink
Velva	Heard
Charles
Ellyn
Elba	Tom
Eleanore	Ambrose
Hien
Dawne	Johns
Billi	Headley
Love	Cheatham
Cayla
Charley
Lizette	Rountree
Nerissa	Cartwright
Kami
Sherril	Vigil
Georgiana	Brower
Agatha	Baird
Elenor	Napier
Ilana	Griswold
Eve
Indira	Colby
Jaleesa	Meyers
Taneka
Malisa	Hearn
Aleta	Sanborn
Elinore	Ledford
Kam	Moyer
Majorie	Flint
Barrie	Mathews
Nichol	Lafleur
Santa	Hudgins
Lauralee	Clough
Terisa
Omega
Miyoko	Monahan
Leisa	Cornwell
Isidra	Askew
Mason	Dubois
Yolande	Womack
Hiroko
Kesha	Denham
Josefa	Tackett
Dorthea	Coyne
Ayako
Toi	Brothers
Bethann	Weatherford
Linette	Seals
Holley	Nielsen
Doria	Hedrick
Retta	Lay
Lecia	Montalvo
Merry
Matha	Odonnell
Lasandra	Chilton
Angelo	Dawkins
Lesia	Pate
Florida	Merchant
Rheba
Sun	Li
Jone
Elfrieda	Stamm
Amparo	Bowden
Shantel	Mejia
Marilee	Higdon
Remona
Qiana	Beals
Gabriela	Esposito
Yulanda	Flannery
Emmitt
Mariella	Maddox
Dalton
Manda	Golden
Dorian	Mayers
Lavon	Sherrill
Karole	Cota
Lan	Mcneil
Dinorah	Witherspoon
Catharine	Hauser
Brenton	Atwell
Elma	Ransom
Pok	Neely
Danyelle	Tapia
Alva	Moeller
Ossie	Hooper
Earlene	Strunk
Sandee	Heredia
Margot	Hannah
Chandra	Baines
Floy	Varney
Collene	Jaramillo
Codi	Stacy
Jamar	Devito
Delphine	Thiel
Kimiko	Baggett
Reva	Iverson
Else	Casas
Glendora	Boyce
Ailene	Trapp
Daniela	Keeler
Thad	Levy
Nelida	Sena
Emely	Venable
Star	Matson
Elana	Weiner
Antione	Forsyth
Taren	Yee
Antonina	Chamberlin
Leopoldo	Finney
Velia	Mcclanahan
Sabina	Stinnett
Santana	Stanfield
Marvel	Pettigrew
Easter	Betz
Tonia	Gerber
Barton	Bowles
Hollis	Concepcion
Tressie
Kathern	Lamm
Epifania	Lemieux
Audria	Headrick
Harmony	Sheets
Una	Dowling
Rosario
Sharen	Whalen
Wilmer	Bankston
Marlyn	Gipson
Kasi
Issac
Stephane	Embry
Nickolas	Messina
Argentina	Minton
Carrol
Erminia	Corcoran
Sherita	Chalmers
Katheryn	Burkholder
Darcey	Royal
China	Lincoln
Jeri	Maloney
Larita	Cheney
Marisa
Nilsa	Chu
Arvilla	Dugger
Candida	Lovett
Dirk	Beeler
Norbert	Adamson
Jude	Peter
Sarai	Spann
Sha	Lindstrom
Oralee	Paredes
Evelyne
Kassandra	Durham
Barb	Delagarza
Tanner
Henriette	Ammons
Chloe	Hickman
Daryl
Florentina	Ferry
Jamika	Grogan
Melaine	Presley
Aisha	Leak
Alissa	Partin
Ferne	Kimmel
Ludie	Linder
Rhoda	Malcolm
Londa	Cormier
Magaret	Gaskins
Angelyn
Valentina	Gainey
Jena	Acosta
Kenna
Jerlene
Alphonso	Barrows
Hyacinth
Mardell	Cornelius
Francina	Thomson
Shanon	Boyle
Phuong	Bair
Arthur	England
Giselle	Obryan
Cyndy
Nikita	Grier
Roselyn	Hutcheson
Ike	Holley
Stanton	Erwin
Vernita	Everhart
Ehtel	Mackenzie
Anisa
Emory
Marquetta	Field
Cyrstal	Orlando
Carlota	Batson
Andria
Latrisha	Matthew
Tammi	Wentz
Marty	Milligan
Ozie	Schaeffer
Evelynn
Serafina	Saucedo
Salome	Tellez
Loreen	Frost
Nobuko	Noland
Tuan	Lovelace
Devorah	Velasquez
Robbin	Garvey
Marcela	Ryder
Fumiko	Eller
Estela	Needham
Elvina
Leida	Upchurch
Kary	Fraser
Joya
Kyong	Busby
Sharron	Trice
Mozella	Fulmer
Harriett	Schilling
Augustus	Griggs
Angelia	Andrus
Estell	Oakes
Karmen
Lizeth	Fortenberry
Ashlie	Lawless
Shizue	Meza
Quinton	Almanza
Maple	Kearney
Normand	Wallis
Margo	Flanagan
Chrissy	Driver
Hiram	Burdick
Leonie
Joseph	Lemons
Chas	Mccabe
Tasia	Power
Susannah	Borges
Enedina	Murrell
Teodoro
Man	Matlock
Racquel	Hodge
Quincy	Woodruff
Luigi	Dexter
Rosaline	Styles
Claudine	Kruse
Donny	Houck
Talia	Betancourt
Miles	Pedersen
Layla	Leblanc
Hilario	Jose
Caridad	Garber
Lorretta
Salena	Preston
Sydney	Bolden
Cary	Travis
Margeret	Doty
Maye	Seal
Shasta	Millard
Jerrica	Beard
Jannie
Candyce
Mora	Hadley
Kristan	Snodgrass
Taina	Gee
Roseanne	Rhoades
Broderick	Kendrick
Sammy	Stegall
Damaris	Davies
Shandra	Neff
Launa
Renay	Middleton
Sol	Root
Lieselotte	Gooden
Tania	Britt
Savanna	Ashford
Devon
Raisa
Verona
Maricela	Nix
Carlos	Harry
Paz	Shipp
Gricelda	Whitman
Tenesha	Holden
Allene	Hagan
Lida	Blankenship
Grisel	Agee
Bulah	Madsen
Bunny	Laplante
Candance	Redmon
Mariette	Weiss
Rutha
Sharolyn
Denver	Guenther
Kandice	Castle
Leota	Chen
Shoshana	Arsenault
Vallie	Wenger
Marcell	Trinidad
Joni	Mace
Cleo	Fries
Yolonda	Swan
Paola	Lister
Kraig	Bowens
Elene	Bratcher
Russell	Vanover
Cathern	Mercer
Eugenia	Stoll
Emiko	Sterling
Francine	Kuntz
Margherita
Leatrice	Dorsey
Windy	Paulsen
Marilynn	Tomlin
Nana	Pimentel
Desmond	Denning
Rodger	Lorenzo
Chasity	Reaves
Sean	Timmons
Eliza	Mcintosh
Ward	Colbert
Dorothea	Yazzie
Marcelo	Finch
Exie	Selby
Magen	Gantt
Lottie
Natalia	Olds
Mara	Pippin
Carolina	Mcbee
Melodi	Farrow
Victor
Cammie	Hass
Lorriane	Marlowe
Ai	Baez
Rosena	Damico
Merri	Mcelroy
Blair	Roby
Monet	Harter
Chanelle
Morton	Vandyke
Edelmira	Hinkle
Jennell	Beattie
Laveta	Pruett
Chassidy	Hamby
Laure
Hellen	Gomes
Rolland	Mead
Carmelo	Funk
Madelaine	Vang
Riva	Wren
Venita	Mcintire
Kortney	Mcmaster
Dominque
Katrice
Tracey	Colwell
Katherina
Maurita	Tilley
Wilhelmina	Shook
Winford	Timm
Tandy	Herzog
Fatimah	Lanham
Celinda	Mullen
Eura	Rader
Mercy	Sperry
Mickey	Reis
Amiee	Gaskin
Tiffanie	Krauss
Alexandria	Diamond
Maritza	Vitale
Toshiko
Willena
Sanda	Cash
Malika	Lozano
Dorine	Hathaway
Lura	Durden
Eddie	Spruill
Marquita	Venegas
Amee	Spivey
Aletha	Cary
Jenae	Royster
Svetlana	Schweitzer
Nakita	Best
Jesusa	Callaway
Lavada
Ethyl	Horsley
Adria	Conley
Ciara	Vidal
Alethea	Batiste
Candy	Grimes
Sandi	Rickman
Malissa	Dent
Andreas	Winchester
Madelene	Varner
Noelle	Dickey
Dwain	Tabor
Esmeralda	Shockley
Bev	Kohn
Abby	Oliva
Chi	Triplett
Tressa	Jacobson
Meda	Tidwell
Lynwood	Cantu
Mazie	Hutto
Lady	Hildreth
Arianna	Gale
Frederica	Ogden
Bettie	Huynh
Jamal	Sumpter
Jonelle	Spalding
Karima	Bustamante
Davida	Irizarry
Eun	Willoughby
Aline	Bannister
Rufina	Berman
Clotilde	Ritchey
Minna	Putman
Jonna	Youngblood
Jenelle	Alarcon
Jeni	Low
Kasey	Epps
Cinderella
Jeanmarie	Meeks
Kathrine	Christman
Renate	Velasco
Awilda	Nabors
Hildegard	Burnett
Tatum
Kizzy	Cyr
John	Byers
Roma
Yu	Acuna
Huong	Aponte
Twanda
Xenia	Campos
Willetta	Canada
Bryon	Leyva
Quentin	Urbina
Lajuana	Sorensen
Lia	Toledo
Hang
Ethan	Cecil
Marylynn	Fallon
Truman	Michaels
Clarence	Burchett
Talitha	Hewitt
Anglea	Birch
Palmer	Mccutcheon
Jinny
Milo	Spriggs
Dylan	Keefe
Lauryn	Mcclain
Beatris	Manns
Enda	Connolly
Larissa	Putnam
Tamie	Arias
Jeane	Broderick
Myung	Lovell
Donetta	Bonds
Tracee	Lockwood
Bailey	Ledoux
Mireille	Deaton
Tyson	Caro
Selena	Carey
Boyce
America	Milton
Carina	Hardin
Larue	Kolb
Carlyn	Couch
Carmel	Deluca
Nieves	Mccorkle
Agustin	Naranjo
Ilona	Hairston
Season	Mojica
Margret	Kidd
Berenice	Correa
Williams	Landers
Young	Perdue
Mozelle	Tarver
Julissa	Akins
Annetta
Maegan	Kincaid
Deshawn	Waggoner
Jay	Salgado
Mindi	Kelso
Louie	Gillis
Lawanna	Muller
Gwyn	Ferraro
Lynna	Billiot
Odell	Colburn
Marni	Gilmore
Antone	Katz
Tess	Matteson
Milagros	Costa
Oda
Guillermina	Branson
Lessie	Smart
Flor	Fulton
Portia	Autry
Deidra	Ervin
Micki	Wolf
Ariane	Allan
Tiera	Mcclung
Rudy	Pierson
Frank	Andrew
Kristal	Chesser
Parker	Beckman
Alisha	Norfleet
Delicia	Reddy
Shalanda	Viera
Kia	Werner
Waldo	Linn
Charleen	Chin
Zenobia	Hales
Diedre	Mcghee
Sheridan
Von	Fitzsimmons
Oleta	Marble
Leo	Hinojosa
Billy	Cardenas
Dillon	Joyce
Lashanda	Lilley
Emeline	Gulley
Everette
Luella	Templeton
Suzy	Ott
Melissia	Hollingsworth
Wanita	Doan
Leisha	Klinger
Loura	Macon
Lillia	Russo
Janella	Brinkman
Pia	Melancon
Claris
Vince	Farnsworth
Chere
Melida
Machelle	Burden
Trent
Dionna	Pagan
Galina
Marketta
Zita	Pannell
Ivana
Augusta
Devon	Leclair
Zelda	Siegel
Eugenie	Paxton
Saundra	Cisneros
Gilma	Noriega
Ashleigh
Florrie	Rawlings
Gigi	Houser
Elise	Leger
Bambi	Stallings
Pamila	Clawson
Ivette	Keith
Ardath	Menendez
Aleen	Pemberton
Evette	Gurley
Michal	Schindler
Latanya
Eleanora	Cantrell
Laurice	Grisham
Letisha	Sisson
Catrina	Bland
Charise	Herrmann
Garland	Kruger
Arden	Machado
Ivey	Cambell
Herschel	Perreault
Suzan	Pfeiffer
Tanesha	Maes
Shonda	Easton
Kyoko
Mariann	Scanlon
Derick	Goff
Alishia	Wynne
Shera	Barger
Kyung	Shanks
Soo	Lugo
Rosy
Lanie	Fleck
Jasper	Ruffin
Lilian	Glaser
Cliff	Murdock
Claudie	Holloman
Otto	Aranda
Donella	Wingfield
Oma	Houghton
Lakesha	Xiong
Rachal	Brand
Ocie	Ferrer
Ping
Niki	Perales
Danyel	Bundy
Drema	Mansfield
Ashanti	Markham
Abbey	Langford
Chantal	Daugherty
Noella	Crowell
Corazon	Parry
Suk	Abel
Zada	Joiner
Ria	Rider
Myrle	Matheny
Mel	Barlow
Garnet	Swann
Blaine	Shade
Twanna
Joette	Moulton
Vina	Connelly
Classie	Bernstein
Chadwick	Broussard
Neely	Blais
Laurine	Murillo
Beverlee	Curtin
Dell	Turpin
Justine	Langston
Elda	Granger
Vergie
Bruna	Wilke
Marivel
Ardis	Ahmed
Theodora	Polanco
Yevette	Kuykendall
Carlee	Chisolm
Sadye	Watt
Scott	Zavala
Lavern	Neel
Rosia	Moses
Elza	Leon
Mathilda	Moniz
Lise	Edge
Tyree	Anders
Millicent	Ocampo
Merlene	Bales
Shanta	Quintero
Marylouise	Deleon
Loree	Cano
Larry	Morrell
Willa	Kinsey
Claudio	Pettis
Luvenia	Hanna
Leonardo	Lash
Ernie
Markita	Majors
Gia	Gagne
Kristyn	Mccollum
Estella
Dee	Lilly
Asa	Speed
Nichelle	Comstock
Donald	Mcgrath
Lannie	Parris
Katharina	Michael
Sari	Kay
Paris	Scully
Thaddeus	Dill
Danilo	Poindexter
Keesha	Boyer
Roxy
Mariam	Arevalo
Olin	Stidham
Sheilah	Hammer
Esteban	Burley
Hsiu	Medley
Natacha	Haley
Etsuko	Bullard
Eboni	Gilliam
Euna	Petrie
Lynnette	Kaminski
Daniella	Villareal
Tristan
Mayola
Romona	Gaddis
Darnell	Dougherty
Lashaun	Free
Michal
Loan	Akers
Hannelore	Hoover
Gidget	Cabrera
Taryn	Hebert
Hollie	Belanger
Arica	Puente
Emogene	Gant
Tambra	Grice
Sachiko	Mcwilliams
Tammie	Bergeron
Raye	Galvan
Margarete	Singletary
Leone
Maynard	Hershberger
Antonia	Eldridge
Carolyne	Jasper
Demetra	Himes
Bobbie	Rich
Leeanne	Newsome
Lucius	Fishman
Theda	Sykes
Valentine	Seiler
Harris	Fagan
Karina	Hutchison
Angelita	Asbury
Chante	Redman
Weldon	Peacock
Deon	Utley
Zena	Dupuis
Jarred	Nealy
Melania	Amato
Leta	Morrissey
Chae	Tapp
Brant	Bigelow
Oswaldo	Mcnair
Elvie	Slocum
Maris	Goss
Lue	Espinosa
Deanne	Michel
Adriane	Swift
Staci
Lavette	Rhea
Janett	Marino
Cherie	Palacios
Ta	Feldman
Emerita	Pipkin
Latoyia	Lofton
Mafalda	Krebs
Jacinda	Corral
Marya	Wicks
Christiane	Cagle
Tyler	Montano
Adele
Gaston	Kozlowski
Heidy	Snowden
Caroyln	Holly
Tobie	Seaman
Tonette	Faust
Wen	Santana
Lashunda
Korey	Kohl
Jenice	Wiley
Louann	Humphreys
Madalyn	Fredrickson
Marna	Jansen
Catrice	Kong
Chantell	Charlton
Michel
Kendal	East
Adrian	Sommers
Alyse	Walston
Florance	Antoine
Royce	Gunn
Robert	William
Lolita	Mello
Freddy	Plante
Darius	Foss
Carey	Creech
Echo	Coley
Brittaney	Blank
Marylyn
Sade	Everett
Alexis
Desire
Jeniffer	Mosier
Taisha	Marquis
Maybell	Jeter
Miguelina	Pullen
Delena	Kendall
Ninfa	Yoon
Raymundo	Jung
Susy	Rohr
Breanne	Vanburen
Bibi
Lesha	Samples
Ronny	Chester
Santina	Starr
Debora	Hooks
Sidney	Christie
Leora
Rikki	Lindsay
Yasmin	Diehl
Concepcion	Prado
Jordan	Blocker
Ladonna	Spradlin
Trinh	Smothers
Dorcas	Cuellar
Piedad	Dunbar
Shea	Wilbur
Deane	Bustos
Oscar	Isbell
Marquitta	Lamar
Nelda	Nicholson
Thalia	Griffiths
Susann	Adair
Stevie	Bozeman
Foster	Lockett
Nicky	Welker
Clemmie	Lance
Alana	Jordon
Treva	Valencia
Geri	Woodbury
Lissa
Alena	Tobin
Fritz	Corbitt
Refugio	Forney
Virgen	Ouellette
Angella	Gagnon
Dewitt	Garrison
Eulah	Locke
Jona	Robles
See	Crook
Lindsay
Daphine	Crews
Yon	Bledsoe
Hung	Whitmore
William	Farias
Nu	Lankford
Babette	Carrion
Prince	Worthington
Nevada	Fryer
Coleen	Jarrell
Marisha	Cason
Talisha	Peachey
Genaro	Canfield
Berniece	Harman
Annmarie	Rouse
Kina	Tatum
Claretta	Bradbury
Florine	Aguilera
Sammie	Beebe
Sixta	Acker
Roseanna
Carey	Geiger
Laurena	Muncy
Verena	Arndt
Lorrie	Alfaro
Jada	Henke
Lupita	Goldstein
Avril
Rafaela	Drury
Lidia	Loyd
Deana	Chatman
Kiera	Prentice
Ressie	South
Dusty	Piper
Kitty	Boehm
Dolly	Lang
Mikel	Langley
Maribeth	Metz
Susanne	Weeks
Tran	Maples
Michale	Butcher
Suzann	Haines
Yuette	Edmondson
Mertie	Corbin
Apryl	Marks
Margarito	Lester
Pearlie	Buford
Rosamaria	Bergman
Zana	Cummins
Rosana	Wellman
Hedy	Parson
Regena	Dietz
Rubye	Oliveira
Valda	Cloud
Danica	Mayhew
Sanjuana	Rowell
Donnie	Wampler
Norris
Deadra	Pack
Hobert	Kilpatrick
Ebonie	Goins
India	Egan
Lorna	Snider
Bruno	Sheffield
Natosha	Booker
Elizebeth	Counts
Ione	Holton
Gil
Dimple	Skidmore
Leonarda	Gay
Celestina	Enriquez
Jolie	Baptiste
Karin
Lyn	Epperson
Terrie	Darling
Eladia	Pointer
Keven	Kidwell
Bianca	Packer
Mao	Sweeney
Sharlene	Caraballo
Karyl	Rawlins
Dona
Jamey	Cassidy
Hortencia	Milner
Holli	Vaughan
Hershel	Raymond
Margurite	Vick
Joella	Dukes
Domenic	Chance
Rhett	Hargis
Misti	Kimbrell
Gussie	Albright
Eulalia	Simone
Elois	Schell
Jutta	Dunlap
Janita	Hamer
Tijuana	Kimble
Felica	Hoang
Yaeko	Loftis
Chieko	Dallas
Manuela	Truong
Johnna	Ruth
Jackqueline
Martin	Malloy
Jeffrey
Val	Mcgovern
Jacquetta	Knudson
Earleen	Greco
Werner	Spurlock
Xiomara	Sales
Dortha	Scoggins
Tawanna	Vallejo
Colby	Musser
Yvone	Mcmillen
Lorine	Matheson
Debbi	Smoot
Lucina	Odell
Isidro
Ardell	Zuniga
Phung	Mosher
Layne	Bourque
Billye	Talbott
Kurtis	Schumacher
Jeanna	Robinette
Sarita	Pritchett
Marguerita	Zeller
Cordell
Anya
Earnestine	Schmitz
Wendolyn	Talley
Alexa	Chun
Kandra	Hermann
Britney	Creel
Tatiana	Kang
Mackenzie	Redmond
Elli	Schaffer
Melina	Schwarz
Louella	Frederick
Liana	Painter
Eloisa	Gaston
Loreta	Lea
Chong
Quiana	Fulcher
Tena
Vonnie
Lilla	Tovar
Perla	Wilkinson
Gretta	Canales
Malvina
Mike
Philomena
Marlin	Land
Buford	Mobley
Mirtha	Mccallister
Arnita	Whittle
Zoraida	Whiting
Natashia	Caudle
Shaquana	Mayberry
Micha	Fusco
Xavier	Arteaga
Greta	Otoole
Verdell	Shore
Marilou	Eaton
Heide
Misha	Bender
Polly	Schmitt
Regine	Blunt
Virgilio	Hardman
Jillian	Luciano
Kacie	Candelaria
Providencia	Emmons
Alejandrina	Brittain
Elodia	Ogle
Carlena	Merrill
Leanne	Huntley
Rhona	Bray
Tai	Avalos
Natisha	Mccloud
Luciana	Alford
Chastity	Mueller
Irish	Martell
Laurene	Arriaga
Marisela	Damron
Gisele
Devora	Patel
Teodora	Krueger
Milda	Burgos
Thuy	Shorter
Stepanie	Fuchs
Clarice	Mccartney
Britta	Switzer
Cristen	Deal
Taunya	Capps
Brock	Lauer
Lorina	Danielson
Leana	Rector
Lashonda	Clary
Malorie	Chau
Napoleon	Abraham
Dulce	Brent
Farah	Hurt
Lizabeth	Bock
Sherice
Ayanna	Graf
Joanie	Wertz
Reyes	Woodson
Roni	Mcnulty
Thersa	Hammett
Shayna	Poe
Belia
Gregoria	Beall
Ester
Ola	Mayfield
Erlene	Pruitt
Bridgett
Sharice	Lau
Lonny	Devries
Cathrine	Warden
Shauna	Elston
Felicidad	Davison
Jc	Dupont
Julieta	Simonson
Chase	Almond
Thurman	Tubbs
Delila	Ridgeway
Zulema	Sells
Berry	Dunaway
Deja	Covington
Marlys	Bobo
Johnette	Dewitt
Agueda	Bourgeois
Vanda	Guajardo
Lauri	Paige
Candi	Hutcherson
Alexia	Whitcomb
Deirdre	Davenport
Burl	Rodrigues
Errol	Shively
Ty	Ridley
Kory	Mundy
Khadijah
Kori	Dyer
Annabell	Eastman
Winnie	Wing
Jeanie	Christiansen
Shante
Edyth	Jacoby
Vena	Jacob
Lorie	Upshaw
Malcom	Bernard
Senaida	Herman
Trudie	Yeager
Ewa	Thrasher
Fernanda	Vela
Ivory	Roth
Cassy	Weems
Maurice
Shannan	Baylor
Juliana
Inga
Selina	Churchill
Kaycee	Tanaka
Usha	Hollins
Xiao	Daley
Rea	Kingsley
Jimmie	Mclean
Margert	Abernathy
Delmy	Zarate
Shara	Centeno
Migdalia	Pendleton
Lin	Knudsen
Denna	Stillwell
Rosalba	Valle
Hiedi	Tang
Shay	Aldrich
Melany	Reiter
Walton	Salerno
Arlean	Anaya
Cori	Coughlin
Anamaria	Herrington
Lakenya	Agnew
Dannie	Blodgett
Jenise
Maud	Rudd
Jae	Howland
Stephan	Honeycutt
Fredericka	Navarro
Junie	Shay
Brian	Desimone
Claude	Whelan
Sherilyn	Cotton
Nan	Adam
Kourtney	Wilcox
Latoria	Beverly
Nickole
Cherryl	Champagne
Brigida	Mcginnis
Orpha	Hite
Janay	Cameron
Eldon	Schafer
Ashly	Jeffrey
Tod	Dobbins
Donita	Liu
Sommer	Cousins
Milford	Hodgson
Jarrett	Jolley
Evon	Salley
Lyndia	Muhammad
Lenna	Huston
Charissa	Coffin
Lanny
Fernande	Culpepper
Ofelia	Wynn
Rona	Barraza
Whitley	Benoit
Lashay	Dwyer
Lacey	Prieto
Reinaldo	Mccallum
Valene	Bess
Spring	Kirchner
Randa	Sneed
Soila	Cochran
Theressa	Steward
Merlin	Saxton
Kasie	Ashby
Dahlia	Schulz
Tomeka	Taft
Deloise	Arrington
Isiah	Boudreau
Charlette	Steffen
Alysa	Soliz
Kenneth	Seymour
Lakia	Aleman
Jarod	Shoemaker
Ileana	Conover
Kimbery	Shelley
Yuko
Tatyana	Hemphill
Theresia	Justus
Shad	Bible
Barbie	Pickering
Jeannetta	Cable
Evita	Mcclure
Jaye	Frame
Brady
Ciera	Casillas
Pei	Sweet
Genie	Paulson
Blair	Pinckney
Ardelia	Vanhoose
Maile	Chacon
Clair	Fogle
Mariko	Lusk
Cassidy	Quigley
Stephani	Dover
Jackeline	Underhill
Jefferson	Humphrey
Elisha	Ireland
Deedee	Locklear
Kathyrn	Courtney
Ali	Haywood
Emery	Callender
Dina	Delong
Pamelia	Osgood
Beatriz	Champion
Althea	Logsdon
German	Staton
Jason	Thorne
Oretha	Krause
Inell	Bower
Linh	Carl
Jospeh	Eddy
Makeda	Hightower
Ara	Jolly
Hoyt	Willey
Jerrell	Wiese
Irina
Hester
Marielle	Delvalle
Nathalie	Clemens
Mayra	Stitt
Del	Irvin
Annice	Boles
Xuan	Word
Kayleen	Cullen
Cruz	Fain
Hanna	Mize
Haydee
Carline
Tyisha	Fierro
Ernestina	Stinson
Cleotilde	Pridgen
Eliana
Dominga	Broome
Veta	Fincher
Petra	Bader
Sharyl	Dugas
Olevia
Rhiannon	Mulligan
Wilfredo
Valeria
Sheryll	Emery
Rocio
Bobbye	Maier
Alanna	Bolton
Houston
Hertha	Goode
Veola	Redden
Quyen	Ash
Regenia
Timothy	Quarles
Vinita
Nadene	Sasser
Chet	Mcclellan
Fermin	Tibbetts
Lanita	Dick
Albina
Tayna	Whittington
Sydney	Rosenthal
Micheline	Albertson
September	Sorrell
Thomasina	Box
Rhea	Madrid
Beverley	Key
Tu	Holcombe
Caryl
Versie	Ponder
Mohammad	Alcorn
Bess	Stafford
Gale	Crittenden
Michel	Manzo
Ulrike	Hannon
Caitlyn	Mccombs
Azzie	Lo
Ivelisse	Lemaster
Maisha	Wilhite
Herlinda
Calista
Cathryn	Bunker
Eleonora	Mccool
Angele	Laughlin
Agustina	Pugh
Liane	Christenson
Jaimee	Bayne
Jeanice	Runyan
Lanelle	Osborn
Brooks	Villarreal
Ngan	Niles
Queen	Hatley
Lauran	Frey
Laquanda	Gorman
Cordia	Delatorre
Rene	Bynum
Shiela	Rodrigue
Signe	Kirkland
Elin	Sprague
Renda	Ellsworth
Andrea	Cass
Nilda	Arellano
Joline
Latricia	Stapleton
Lawrence	Fair
Meagan	Mcdade
Krystina	Caskey
Elsy	Mosley
Kaleigh	Johansen
Vesta	Watters
Reagan	Gaither
Solomon	Leslie
Chi	Canty
Jimmy	Fong
Gudrun	Lu
Karlyn	Pounds
Gertude	Quintana
Joaquin
Karlene	Handley
Milan	Christy
Kirby	Bronson
Alease	Noel
Jenette	Rush
Elmer	Sayre
Gearldine	Early
Latrice	Earls
Evelin	Muir
Damion	Feeney
Lavera	Bolin
Rolande	Leigh
Curtis
Verda	Winkler
Miquel	Luttrell
Allyn	Crisp
Charita	Stover
Adelia	Lewandowski
Suellen	Leach
Yung	Furman
Rasheeda	Pike
Jacquiline	Lemay
Mimi	Lackey
Leeann	Givens
Cleveland	Woodall
Wilber	Mackey
Amberly	Razo
Peter	Beaver
Nedra	Greenlee
Alysia	Baron
Candelaria	Keck
Man	Sibley
Kaley	Shultz
Tilda	Buckley
Deidre	Newkirk
Lasonya	Major
Sherise
Iraida	Benavides
Carin	Gould
Judie	Chapin
Connie	Burkhart
Neva	Ritter
Dorotha	Prichard
Elwood	Schulte
Annamae	Robert
Rosalee	Reilly
Marg
Brittney	Dix
Vanna	Boling
Edris	Nieto
Akilah
Jarrod	Parham
Christoper	Starnes
Viva	Orozco
Macie	Sheppard
Artie	Carranza
Christinia	Carrasco
Madeleine
Jennette	Childs
Chance	Nagel
Dorinda	Gilman
Jonas	Mixon
Robby	Omalley
Anastasia	Borders
Frances	Doran
Marshall	Ives
Jeremy
Kenya	Mcfarland
Luann	Richie
Leighann	Staley
Elnora	Hamel
Shirl	Rockwell
Debby	Estrella
Ena	Slater
Freeda	Breen
Josue
Kirstie	Estes
Reggie	Blalock
Janine	Welsh
Josephina	Skaggs
Clarine	Blevins
Sharri	Marlow
Shiloh	Alston
Cristobal	Durant
Jenni	Whatley
Marcelene	Eggleston
Yong	Hughey
Dena	Bostick
Song	Ferrara
Regan
Katerine	Mcnamara
Johnie
Theo	Tice
Babara	Motley
Delana	Vo
Lenard	Schubert
Loria	Cheng
Vincenzo	Chow
Keisha	Tamayo
Edward	Hundley
Toney	Carrier
Odell	Maher
Hilde	Loomis
Consuelo	Charles
Brenna	Babcock
Kaitlin
Gilda	Tanner
Carley	Lord
Karissa	Stearns
Aleshia	Doherty
Lucilla	Camacho
Dalia
Brett	Bostic
Sherill	Pederson
Pattie
Fred	Shepard
Walker	Rubin
Ursula	Mccloskey
Jammie
Micah	Fellows
Mana	Gladden
Kathline
Annalee	Greiner
Walter	Tharp
Haywood	Pendergrass
Un	Gorham
Emilie	Torrez
Cari	Pacheco
Daniell	Salcido
Ned	Benner
Tesha	Zielinski
Bernadine
Luci	Case
Clair	Applegate
Herma
Jina
Garfield	Earl
Benita	Ragsdale
Mohammed	Enos
Ashlea	Southerland
Alene
Evonne	Corey
Rachell	Fahey
Lavone	Fugate
Russel	Smiley
Scarlett	Khan
Johnson	Homan
Dot	Sampson
Cuc	Mcarthur
Neville	Beauchamp
Carmine	Shipman
Collen	Binkley
Christeen	Elrod
Tamiko	Penn
Felicitas	Hazel
Marin	Sessions
Maya
Lesley	Hawk
Trisha	Dugan
Kennith	Shea
Timika	Sisco
Willette	Pollack
Ladawn	Kauffman
Tiffani	Larkin
Bridgette	Silver
Adelle	North
Maire	Darden
Deon	Thigpen
Ayesha	Collazo
Shemeka	Milburn
Domonique	Delaney
Denisha	Plummer
Titus	Ferrari
Velvet	Tavares
Kayce	Kelsey
Jenee	Pelletier
Hana	Turk
Mittie	Diggs
Sherika
Nelia	Rosas
Ligia	Wilks
Lorenza	Dobbs
Mica	Swenson
Fidela	Hefner
Marica	Waugh
Kirby	Gilchrist
Gracie
Doretta	Chaffin
Francesco	Collado
Hue	Villa
Tamatha	Barfield
Jeanett	Rubio
Jacalyn	Tuck
Lacresha	Ragan
Tiny	Forman
Anitra	Montague
Rashad	Yoo
Jaqueline	Fink
Francisca	Mowery
Carlo
Madaline	Chappell
Carli
Debbra	Rand
Evelina	Haag
Janey	Roper
Lorrine	Jarvis
Sima	Slone
Diedra	Veal
Imogene	Jeffery
Maira	Duarte
Giuseppina	Marvin
Julee	Wilbanks
Tabetha	Choate
Lamonica	Petit
Dagmar	Munson
Pennie	Ludwig
Loni	Pinson
Adrianne	Siler
Linsey	Worth
Lina	Croteau
Lean	Walls
Rosendo
Ivory	Mcvey
Seymour	Dunning
Violeta	Corbett
Jeffie	Daigle
Kera	Moseley
Eilene
Nelle	Beal
Leeanna	Humphries
Laurinda	Pitts
Maribel	Moreland
Pricilla	Olivas
Porter	Downs
Travis	Cooke
Karena
Matilde	Meehan
Gerda	Duvall
Arlena	Jewett
Merilyn
Brandie	Hurtado
Marcelina	Ashley
Sherwood	Atwood
Lilli	Berrios
Ja	Chestnut
Sunni
Elvis	Luke
Keely	Garnett
Faviola	Aragon
Angeline	Horan
Evia	Williford
Creola	Tuttle
Florinda	Olivares
Princess	Shores
Vikki	Burks
Hayden	Peel
Felicita	Kerns
Jarvis	Lindberg
Wonda	Hester
Flavia	Potts
Mauro	Whitmire
Shena	Paterson
Margene	Searcy
Sang	Castleberry
Jayne	Martins
Magdalen
Siu	Bisson
Gabrielle
Genia
Teddy	Fajardo
Bernardine
Fletcher	Menard
Neomi	Overton
Goldie	Latimer
Bernardina
Deloris	Crowder
Lilly
Jewell	Morse
Adah	Cardwell
Scot	Blue
Margareta	Chong
Lashawn
Emilee	Regalado
Heath	Grover
Loise	Tobias
Logan	Huggins
Doreatha	Chisholm
Stephany
Cyrus	Creamer
Maxima	Raney
Chasidy	Mcreynolds
Elvia	Guffey
Ashli	Chavis
Chana	Stroud
Nona	Wilburn
Alita	Montanez
Dominique	Weller
Romelia	Roe
Elina	Severson
Maryam
Sook	Landry
Donya
Jasmin	Alger
Chara	Oconner
Christian	Maupin
Alonso	Dewey
Deandra	Grantham
Quinn	Tompkins
Helaine	Horowitz
Shavon	Ledesma
Susanna	Saavedra
Jose	Clem
Delcie	Goldsmith
Dovie	Brubaker
Caryn	Tibbs
Karisa	Ralph
Antonietta	Duggan
Tennie	Haight
Brande	Rock
Delinda	Woodworth
Sam	Hanks
Reiko	Lenz
Annabel	Engel
Audie	Odom
Earle	Escamilla
Lakeshia	Knowles
Deb	Roldan
Brunilda	Blythe
Marlin	Hood
Iesha	Mcgrew
Trina	Folsom
Marianna	Hitt
Coleman	Friend
Danae	Gillespie
Dorris
Palmira	Rawls
Anisha	Whipple
Delsie
Janell	Boisvert
Tarsha	Fountain
Gus	Wingate
Cindi	Ware
Sheba	Hurst
Lovella	Yancey
Roberto	Ibarra
Cheri	Ayres
Barrett	Macklin
Despina	Layton
Davis	Lott
Yessenia	Oneal
Eleonor	Wheat
Gayla	Epstein
Judi	Peck
Rubin	Nagle
Ginette	Adler
Myrtie
Keren	Hayden
Diamond
Linnie	Naquin
Renita	Mcculloch
Coralie
Leon	Reno
Joeann	Easter
Aliza	Sexton
Larhonda	Bratton
Shanel	Dancy
Carmelia	Gist
Phylis	Zook
In	Grossman
Mirian
Lizbeth	Billups
Angeles	Rucker
Lavern	Tejada
Kristian	Conger
Voncile	Hostetler
Clemente	Conaway
Hwa
Modesto	Weinstein
Wiley
Taylor	Aiello
Venice	Reece
Blythe	Ellington
Georgeanna
Iola
Gertha	Villasenor
Hunter	Mcafee
Anika	Hilliard
Alfredia
Emelina	Aaron
Dean	Meeker
Monroe	Eason
Frieda	Stauffer
Rupert	Carlin
Sharyn	Coward
Yanira	Toney
Melisa	Samuels
Leesa	Billingsley
Shanelle	Guthrie
Mikaela
Ha	Edmond
Jadwiga	Peace
Tiara	Laster
Patrina
Raelene	Newby
Sunshine	Fredericks
Luna	Sadler
Tony	Oglesby
Winona	Beane
Maryanna	Longo
Kathaleen	Clifford
Yolando	Kraft
Jackelyn	Renfro
Vicenta	Heath
Soraya	Poston
Tomi
Latonia	Branch
Olinda	Mathias
Amina	Randle
Ivy	Muniz
Jonnie
Vicente	Joy
Bettye	Velez
Frida	Dietrich
Carri	Verdin
Lakeesha	Heim
Bernarda
Calandra	Salmon
Yen	Byrne
Leonila	Mayo
Clelia	Connell
Maryjo
Zane	Mahon
Lyndsey	Oldham
Lenita	Gaffney
Tosha	Fort
Ingeborg	Comer
Ezra	Tijerina
Alessandra	Espinal
Shavonne	Marroquin
Mitchel	Do
Glady	Pomeroy
Chauncey
Zoila	Mckee
Skye	Hastings
Tomiko	Lombard
Corrie	Peralta
Nolan	Armijo
Andre	Shuman
Hilaria	Rayburn
Myesha	Dotson
Sudie	Cowart
Jamel	Carlos
Florentino	Haney
Celena	Card
Hipolito	Jenson
Marilu	Bragg
Dario	Trask
Fredda
Graciela	Baxter
Cherilyn	Keenan
Myrtis	Brantley
Lera	Teal
Jayson	Brewster
Rayford	Lively
Iluminada	Kiefer
Winter	Lund
Arlyne	Gallegos
Maurine	Bateman
Lenora	Slaughter
Tomoko	Waldrop
Dionne	Cavanaugh
Lulu	Doughty
Alyce	Burdette
Shelby	Delossantos
Rina	Sam
Bette	Kaplan
Sharleen
Berna	Ahrens
Nicol	Salter
Shelba	Anglin
Delaine	Huber
Mac	Cohn
Audrie	Stubblefield
Josie	Crowe
Tangela	Rains
Mikki	Shrader
Crystle
Audra	Peoples
Wes	Mcmurray
Stan	Saylor
Hailey	Isaac
Verline
Shirlene	Christian
Shawn	Flaherty
Karon	Breedlove
Danille	Ewing
Manual	Dehart
Donette	Chan
Beata	Benjamin
Willian	Blackwell
Marcy	Sawyer
Araceli	Lyman
Ghislaine	Cloutier
Glory	Killian
Jonie	Felder
Neida	Mock
Allie	Herndon
Pasquale
Shon	Aguirre
Flo	Burnette
Melda	Batten
Blake	Emanuel
Sarina	Vaught
Shakita	Westfall
Becki	Glenn
Ruthanne	Vanhorn
Tula	Savage
Deetta	Tyree
Dorene	Good
Laraine	Mcgehee
Tory
Shizuko	Oakley
Elease	Osburn
Anthony	Sledge
Mignon	Mckeever
Joana
Eryn	Larose
Rima
Ludivina	Calhoun
Hai	Perryman
Scotty	Irish
Hettie	Hutchings
Margy	France
Joane
Forest	Greenwood
Lucienne	Ramon
Elenore	Jobe
Tammara	Lorenz
Aundrea	Pantoja
Jenniffer	Cardoza
Leonida	Casteel
Monte	Hartwell
Emelia	Reinhardt
Julieann	Cramer
Daria	Stpierre
Alise	Wester
Rory	Meadows
Nena	Cardona
Debi	Wild
Danial	Lear
Octavio	Findley
Ingrid	Willard
Denisse	Bone
Tori
Rosella	Tenney
Morgan	Danner
Irwin	Stockton
Olympia	Briseno
Nam	Hsu
Sang	Vanwinkle
Beau	Neil
Inge	Lin
Bula	Nowak
Claribel	Lange
Colby
Coreen	Dias
Thomasena	Dell
Catherin	Farrington
Ambrose	Casper
Les	Foley
Stacy	Oates
Tia	Bowser
Nickie	Kyle
Lekisha
Georgine	Flood
Raeann	Walden
Natalya	Steen
Trena	Her
Jolynn
Brynn	Guillory
Jewell	Hogue
Ruthie	Herrick
Yan	Neuman
Elia	Solis
Eusebio	Skipper
Sebrina	Mccarty
Ami	Provost
Elenora	Mattingly
Gertrudis	Weldon
Fairy	Purvis
Mauricio
Melodie	Jeffers
Arla	Camp
Tonita	Bruce
Joslyn
Janise	Gavin
Earline	Gaddy
Joesph	Slagle
Cris	Neeley
Jessenia	Le
Darron	Giles
Isaiah	Martens
Tova
Bo	Osteen
Elvin	Devlin
Ima	Mcclintock
Marcelino	Larsen
Darci	Baumgartner
Rocco	Weir
Narcisa	Horvath
Thi	Stanton
Novella
Britt	Custer
Vivan	Fullerton
Deangelo	Nolan
Ginny	Sowell
Minta	Spicer
Sung	Gibbons
Mirta	Dickens
Earlean	Paine
Ethelyn	Dobson
Shaunta	Dorman
Jacquie	Downey
Zona	Roller
Penney	Condon
Verlie	Rizzo
Liberty
Jaimie	Jacks
Apolonia	Gallardo
Flossie
Melita	Lowery
Susana	Boyles
Brittny	Brenner
Rebecka	Sanford
Edda	Thorton
Buena	Briones
Nicola	Mcfall
Dotty	Wahl
Charolette	Kaufman
Renea
Marcelle
Julian	Otto
Magda	Taber
Carmelita	Jacobsen
Dusti	Zamora
Jami	Reardon
Enriqueta	Conners
Roxie	Gaines
Azucena	Bernier
Whitney	Mount
Myrta	Brice
Paige	Carrillo
Thresa	Gooch
Demetrice	Kirkwood
Vito	Thomason
Buster	Conn
Willodean
Deandrea	Stacey
Kaitlyn	Nevarez
Jerri	Mosby
Gisela	Stuckey
Arcelia	Phipps
Ileen	Satterfield
Lynetta	Fenner
Stacie	Hadden
Caterina	Pressley
Odelia
Leda	Bain
Jaymie	Howerton
Yuonne	Brackett
Zofia	Quick
Dyan	Willett
Tonja	Hallman
Zenaida	Laney
Seema	Donohue
Geralyn	Valerio
Daysi	Doe
Georgianne
Nicky	Willingham
Callie	Knott
Angle	Dorn
Jayna	Morrow
Zelma	Whiteside
Carol	Abreu
Jin	Fortin
Tarra	Daily
Libbie	Weathers
Amado
Melva	Pearce
Louie	Rowland
Malinda	Amaral
Rodrick	Sturgill
Hildred	Whitney
Charline	Unger
Samella	Engle
Catherina	Dowdy
Odilia	Castellano
Leila
Kalyn	Munn
Rosetta	Schrader
Fabian	Dupre
Justa	Ricci
Katelyn	Romano
Cassondra	Jeffries
Carlita	Dale
Tama	Boswell
Carleen	Bottoms
Merrilee	Felton
Marylee	Durbin
Candis	Burnham
Destiny	Goldberg
Eusebia	Mcdermott
Golda	Rickard
Kerri	Sheridan
Lavenia	Mckeown
Patrice	Mcadams
Glenn	Treadway
Bethanie	Hutchens
Tyesha	Gore
Ema	Lawler
Antony	Southern
Denis	Wenzel
Torrie	Aldridge
Conchita	Rounds
Lesli	Quinlan
Vaughn	Harp
Kit	Barajas
Adela	Whited
Ilda	Robb
Marget	Huddleston
Christene
Ila
Kelsey	Hoppe
Cole	Coffey
Cierra	Gary
Georgianna	Moriarty
Darcy	Poore
Tamela	Jaynes
Hui	Stringer
Chung	Crane
Humberto	Latham
Felecia	Layne
Solange	Abney
Dusty	Rushing
Shawnna	Parish
Odette	Maestas
Fredricka	New
Laci	Willson
Dorian	Batchelor
Anjanette	Sturm
Jeramy	Light
Gaye	Tillman
David	Snow
Ruthann	Gunderson
Weston	Riggins
Shila	Sosa
Moon	Conrad
Zoe
Sharonda	Hull
Josiah	Lutz
Bradly	Libby
Isabell	Bright
Lurlene	Anthony
Chu	Drayton
Vance	Pinkerton
Lexie	Mena
Rory	Valles
Collin	Bivens
Petrina	Curley
Athena	Maclean
Heriberto	Boynton
Kasandra	Regan
Gala
Jetta	Means
Laronda	Conroy
Nada	Harley
Kareem	Springer
Rebeca	Bowlin
Maia	Coyle
Katia	Farrell
Maximo	Phelan
Lucio	Dickinson
Sol	Root
Brianna	Macdonald
Shawanna	Brownlee
Rochell	Purcell
Aleida
Paulita	Hummel
Particia	Guerra
Kris	Sammons
Waltraud	Mackay
Joycelyn	Foret
Sherly	Orellana
Francesca	Fitzpatrick
Suzette	Lowry
Necole
Dick
Cathie
Lavonda	Knapp
Griselda
Brice	Monroe
Christel	Barnhart
Lang	Duke
Gaynell	Kelleher
Catina	Hays
Shemika	Musgrove
Loyce	Langlois
Paulene	Haas
Georgette	Irving
Masako	Carvalho
Yoko	Cornish
Markus	Villanueva
Cordie	Lerner
